!bt	BitTorrentIncompleteDownloadfile
!qb	qBittorrentPartialDownloadfile
!ut	uTorrentIncompleteDownloadfile
#24	Printerdatafilefor24pinmatrixprinter(LocoScript)
#ib	Printerdatafile(LocoScript)
#sc	Printerdatafile(LocoScript)
#st	Standardmodeprinterdefinitions(LocoScript)
$#!	Cryptext
$$$	Temporaryfile
$00	Pipefile(DOS)
$01	Pipefile(DOS)
$db	Temporaryfile(dBASEIV)
$ed	Editortemporaryfile(MSC)
$er	GroupWiseDatabase
$o1	Pipefile(DOS)
$vm	Virtualmanagertemporaryfile(Windows3.x)
^^^	Pervasive.SQLDatabasefile
__a	FileSplitter&JoinerEncryptedfile
__b	FileSplitter&JoinerEncryptedArchivefile
_dd	NortonDiskDoctorRecoveredfile
_eml	WindowsLiveMailEmailfile
_nws	WindowsLiveMailNewsgroupCopyfile
_p	MaliciousSoftwareRemovalToolTemporaryfile
~$~	Temporaryfile(1stReader)
~ap	OldAppExpertprojectdatabase(BorlandC++4.5)
~de	Projectbackup(BorlandC++4.5)
~hm	HostMonitorTestListBackupfile
~mn	Menubackup(NortonCommander)
{pb	CorelWordPerfectDocumentIndexfile
\201$\201	Temporaryfile(1stReader)
000	ImageDataRecoveryfile
001	NortonGhostSpanfile
075	75x75dpidisplayfont(VenturaPublisher)
085	85x85dpidisplayfont(VenturaPublisher)
091	91x91dpidisplayfont(VenturaPublisher)
096	96x96dpidisplayfont(VenturaPublisher)
0b	PrinterfontwithlineDrawextendedcharacterset
0xe	F-SecureRenamedVirusfile
1	InnoSetupBinaryfile
10	IBMVoiceTypeScriptfile
113	IomegaBackupfile
123	Lotus1-2-3Spreadsheetfile
15u	PrinterfontwithPIfontset(PageMaker)
1pe	TurboTaxFormfile
1ph	TurboTaxfile
1st	UsuallyREADME.1STtext
2	SetupFactory6.0setuplauncher
264	RippedVideoDatafile
2d	2dDrawings(VersaCad)
2da	2DimensionalDataArrayfile
2dl	2dLibraries(VersaCad)
3d	3dDrawings(VersaCad)
3dl	3dLibraries(VersaCad)
3dv	3DVRMLWorld
301	Fax(SuperFAX2000-Fax-Mail96)
386	Intel80386processordriver(Windows3.x)
3da	3DAssemblyfile
3dd	ArcGlobeDocumentfile
3dr	3DMarkBenchmarkfile
3ds	Graphics(3DStudio)
3dt	Databasefor3Dmindmap/conceptmap(3DTopicscape)
3fx	Effect(CorelChart)
3g2	3GPP2fileformat
3gp	3GPPMultimediafile
3gr	Datafile(WindowsVideoGrabber)
3ko	NGRAINMobilizer
3me	TurboTaxFormfile
3mm	3DMovieMakerMovieProject
3pe	TurboTax2008Formfile
3t4	BinaryfileconvertertoASCII(Util3)
411	SonyMavicaDatafile
4c$	Datafile(4Cast/2)
4dv	4DViewUltrasoundfile
4mp	4-MP3Databasefile
4sw	4dosSwapFile
4th	Forthsourcecodefile(ForthCMP-LMIForth)
5cr	PreconfigureddriversforSystem5crandSystem5crPlus
669	Music(8channels)(The669Composer)
6cm	Music(6ChannelModule)(TritonFastTracker)
777	7-Zipcompressedfilearchive
7z	7-Ziparchivingformat
8	A86assemblersourcecodefile
8b?	AdobePhotoshopPluginfile
8ba	AdobePhotoshopPluginfile
8bf	AdobePhotoshopPluginfile
8bi	AdobePhotoshopPluginfile
8cm	Music(8ChannelModule)(TritonFastTracker)
8li	PhotoshopScriptingPlug-in
8m	PrinterfontwithMath8extendedcharacterset(PageMaker)
8pbs	AdobePhotoshopMacintoshfile
8u	PrinterfontwithRoman8extendedcharacterset
a	Adasourcecodefile
a0?	ALZipSplitArchivefile
a11	GraphicsAIIMimagefile
a2b	A2BPlayerPlaylist
a3d	Amapi3DModelingfile
a3m	UnpackagedAuthorwareMacIntoshfile
a3w	UnpackagedAuthorwareWindowsfile
a4a	Authorware4.xLibrary
a4m	UnpackagedAuthorwareMacIntoshfile
a4p	Authorwarefilepackagedwithoutruntime
a4w	UnpackagedAuthorwareWindowsfile
a5w	UnpackagedAuthorwareWindowsfile
aa	AudibleAudiofile
aab	MacromediaAuthorwareBinary
aac	AdvancedAudioCodingMPEG-2,MPEG-4
aam	Authorwareshockedfile
aax	AudibleAudiobookfile
ab2	Parson'sAddressBook
ab6	Datafile(ABStat)
ab8	Datafile(ABStat)
aba	PalmAddressBookfile
abc	ActionScriptByteCodeFile
abd	AmBizBonusCalculatordatafile
abf	AdobeBinaryFont
abi	ABICODEREncryptionsoftware
abk	Automaticbackupfile(CorelDRAW)
abm	ImagePalsPhotoAlbumDocument
abr	AdobePhotoshopbrushfile
abs	Abstracts(infofile)
abw	AbiWorddocument
abx	WordPerfectAddressBookfile
aby	AOLfile(locatedinAOLprogramdirectory)
ac3	AC3AudioFileFormat
aca	MicrosoftAgentCharacterfile
acb	Graphics(ACMB)
acc	Program(DR-DOS-ViewMax)(GEM/resident)
acd	SonicFoundryAcidmusicfile
ace	AceArchiver/WinAcecompressedfile
acf	MicrosoftAgentCharacterfile
aci	ACIDevelopmentAppraisal
acl	MicrosoftOfficeAutoCorrectionfile
acm	AudioCompressionManagerDriver
acorn	ACORNGraphicsformat
acs	MSAgentCharacterfile
acs2	AIMP2MediaPlayerSkinfile
acsm	AdobeContentServerMessagefile
act	Actorsourcecodefile
acv	OS/2AudioDrivers
ad	Screensaverdata(AfterDark)
ada	Adasourcecodefile
adb	AdaPackageBody
adc	Bitmapgraphics(16colors)(Scanstudio)
ade	MicrosoftAccessProject
adf	AdapterDescriptionfile
adi	Graphics(AutoCAD)
adl	Mcaadapterdescriptionlibrary(QEMM)
adm	AfterDarkScreenSaverModule
adn	Add-in(Lotus1-2-3)
ado	PhotoshopDuotoneOptions
adp	FaxWorksModemsetupfile
adr	AddressBook
ads	AdaPackageSpecification
adt	Datafileforcardfileapplication(HPNewWave)
adx	Document(ArchetypeDesigner)
adz	GZ-PackedAmigaDiskfile
aeh	iPerAdvancedEmbeddedHypertext
aep	AdobeAfterEffectsProjectfile
aex	PGPArmoredExtractedPublicEncryptionKey
af2	Flowchart(ABCFlowCharter2.0)
aff	AnyFormFormfile
afi	Truevisionbitmapgraphics
afl	Fontfile(forAllways)(Lotus1-2-3)
afm	Type1fontmetricASCIIdataforfontinstaller(ATM-
afs	AdobeTypeManagerfontset
aft	AnyFormtemplatefile
ag	Applixwaregraphicsfile
agp	AspenGraphicsPages
agw	AspenGraphicsWindows
ai	Vectorgraphics(AdobeIllustrator)
aiff	Audiointerchangefileformat
ain	CompressedfilearchivecreatedbyAIN
aio	APLfiletransferformatfile
air	AdobeAIRInstallationPackagefile
ais	ArrayofIntensitySamplesgraphics(Xerox)
aix	Datafileforcardfileapplication(HPNewWave)
ajp	JPEG2000Digitalclosed-circuittelevision(CCTV)security
alb	JASCImageCommanderAlbum
albm	webAlbumPhotoAlbum
all	Formatfileforworkingpages(Always)
als	AliasImage
alt	Menufile(WordPerfectLibrary)
alx	ActiveXLayoutfile
alz	ALZipCompressedfile
amf	Music(AdvancedModuleFormat)
amff	AmigaMetafile
amg	CompressedfilearchivecreatedbyAMGC
amp	PhotoshopArbitraryMapSettings
amr	AdaptiveMulti-RateACELPCodec
amv	AMVVideofile
amx	AfterEffectsMotionExchangefile
anc	Animationfileformat(MorphInk)
ani	Animation(Presidio-many)
anm	Animation(DeluxePaintAnimator)
ann	HelpAnnotations(Windows3.x)
ans	Ansigraphics(characteranimation)
aos	Add-OnSoftware(Nokia9000)
ap	CompressedAmigafilearchivecreatedbyWHAP
apc	Printerdriver(Lotus1-2-3)
apd	Printerdriver(Lotus1-2-3)
ape	Musicformat(differentplayers)
apf	Printerdriver(Lotus1-2-3)
api	AdobeAcrobatPluginfile
apk	AndroidPackagefile
apl	APLworkspaceformatfile
apm	ArcPad6file
app	Add-inapplicationfile(Symphony)
apr	Employeeperformancereview(EmployeeAppraiser)
aps	MSVisualC++file
apx	Appexpertdatabasefile(BorlandC++4.5)
arc	CompressedfilearchivecreatedbyARC
arf	AutomaticResponsefile
arg	AutoCADProfileExportfile
ari	CompressedfilearchivecreatedbyARI
arj	CompressedfilearchivecreatedbyARJ(arj241.exe)
arl	AOLOrganizerFile
ark	ArcfilearchivecreatedbyCP/MportofARCfilearchiver
arr	Arrangement(AtariCubase)
ars	AdobeAfterEffectsRender
art	Graphics(scrapbook)(ArtImport)
arv	ArsivFile
arx	CompressedfilearchivecreatedbyARX
asa	MSVisualInterDevfile
asc	Asciitextfile
ascx	MicrosoftASP.NETusercontrolfile
asd	Autosavefile(WordforWindows)
asf	Datafile(STATGRAPHICS)
ash	Assemblylanguageheaderfile(TASM3.0)
asi	Assemblerincludefile(TurboC-BorlandC++)
asl	AdobePhotoshopLayerfile
asm	Assemblysourcecodefile
asmx	Microsoft.NETWebServicefile
aso	Assemblerobject(objectorientated)file(TurboAssembler)
asp	MicrosoftActiveServerPage
aspx	MicrosoftASP.NETfile
asr	MsAutomapRoute
asx	MicrosoftWindowsMediaActiveStreamRedirectorfile
asx	MicrosoftAdvancedStreamingFormat
at2	Autotemplate(AldusPersuasion2.0)
atm	AdobeTypeManagerdata/info
atn	AdobePhotoshopActionfile
atr	LightscapeMaterialLibrary
att	AT&TGroup4Bitmap
aty	3DTopicscape(Exportedassociationtype)
au	Sound(audio)file(SUNMicrosystems)
au3	Autoit3scriptfile
aud	Audiofile
aut	AutoItScript
aux	Auxillaryreferences(TeX/LaTeX)
ava	Publication(Avagio)
avb	InoculanAnti-Virusvirusinfectedfile
avd	AveryLabelProDatafile
avi	AudioVideoInterleavedanimationfile(VideoforWindows)
avr	AudioVisualResearchfile
avs	Animationfile
avx	ArcViewfile
aw	Textfile(HPAdvanceWrite)
awb	LavasoftAd-awarebackupfile
awd	AWDMSFax
awe	AdobeAcrobatBookmarkXMLfile
awk	Awkscript/program
awm	Movie(AnimationWorks)
awp	MicrosoftFaxkeyviewer
awr	TelsisDigitalAudiofile
aws	Data(STATGRAPHICS)
ax	DirectShowFilter
axd	AveryLabelProRe-Indexfile
axe	ParadigmC++IntegratedDebuggerfile
axg	MSAutorouteTripfile
axl	ArcIMSXMLProjectfile
axs	AMXAxcesscontrolsystemfileformat
axt	ZenWorkssnAPPshotASCIIApplicationObjecttemplate
axx	axxessfilesusedasbackupsofInter-Teldatabases
azw	AmazonKindleeBookFile
azz	AZZCardfile
b	Batchlist(APPLAUSE)
b&w	Blackandwhitegraphics(atari-mac)
b~k	backupfile
b00	CDImageSegmentfile
b16	PCOGraphicfile
b1n	Bothmonoandcolorbinaryscreenimage(1stReader)
b1s	Booksmith
b30	Printerfont(JLaser-Cordata)(VenturaPublisher)
b3d	3DBuilderfile
b5i	Blindwrite5DiskImagefile
b5t	Blindwrite5ImageInformationfile
b6i	Blindwrite6DiskImagefile
b6t	Blindwrite6ImageInformationfile
b8	Rawgraphics(onebyteperpixel)planetwo(PicLab)
b_w	Blackandwhitegraphics(atari-mac)
bad	Badfile(Oracle)
bag	PMMailMailIndexfile
backup	Ad-AwareReferencefile
bak	Backupfile
bal	Musicscore(Ballade)
ban	SierraPrintArtistBanner
bar	Horizontalbarmenuobjectfile(dBASEApplication
bas	Basicsourcecodefile
bat	Batchfile(DOS)
bb	Databasebackup(Papyrus)
bba	SettlerIVArchivefile
bbl	Bibliographicreference(TeX/BibTeX)
bbm	Brush(DeluxePaint)
bbs	BulletinBoardSystemannounceortextinfofile
bc!	BitcometIncompletedDownloadfile
bcf	ConfigSafeSnapshotindex
bch	Batchprocessobjectfile(dBASEApplicationGenerator)
bck	Backup
bcm	MSWorksCommunicationsfile
bcn	BusinessCardProDesign
bco	Outlinefontdescription(Bitstream)
bcp	BorlandC++makefile
bct	BusinessCardDesignertemplate
bcw	Environmentsettings(BorlandC++4.5)
bde	BorlandDatabaseEngine
bdf	BitmapDistributionFormatfontfile(X11)
bdm	AVCHDIndexfile
bdmv	Blu-rayinformationfile
bdr	Border(MSPublisher)
bez	Outlinefontdescription(Bitstream)
bf2	Bradford2font
bff	Binaryfileformat
bfm	Fontmetrics(unix/Frame)
bfs	TivoliStorageManagerfile
bfx	Fax(BitFax)
bga	Bitmapgraphics
bgt	Quicken2002InternetCommonFile
bgi	BorlandGraphicsInterfacedevicedriver
bgl	FlightSimulatorsceneryfile
bgt	Quicken2002InternetCommonFile
bib	Bibliography(ASCII)
bic	CivilizationIIIScenario
bid	BidMaker2002file
bif	BinaryImageFormatb&wgraphics(ImageCaptureboard)
bik	BioCharterProfilebackupfile
bin	Binaryfile
bio	OS/2BIOS
bip	Free-motioncapturefilesforcharacterstudiobiped
bit	BitmapImage
bk	Faxbook(JetFax)
bk!	Documentbackup(WordPerfectforWin)
bk1	Timedbackupfilefordocumentwindow1(WordPerfectfor
bk2	Timedbackupfilefordocumentwindow2(WordPerfectfor
bk3	Timedbackupfilefordocumentwindow3(WordPerfectfor
bk4	Timedbackupfilefordocumentwindow4(WordPerfectfor
bk5	Timedbackupfilefordocumentwindow5(WordPerfectfor
bk6	Timedbackupfilefordocumentwindow6(WordPerfectfor
bk7	Timedbackupfilefordocumentwindow7(WordPerfectfor
bk8	Timedbackupfilefordocumentwindow8(WordPerfectfor
bk9	Timedbackupfilefordocumentwindow9(WordPerfectfor
bkf	MicrosoftBackupfile
bkg	Backgroundfile
bkp	Backupfile(Write-TurboVidionDialogDesigner)
bkw	Mirrorimageoffontset(FontEdit)
blb	DreamWorksResourceArchive
bld	Bloadablepicture(BASIC)
blend	Blender3Dfile
blf	WindowsRegistryRecoveryfile
blg	BinaryPerformanceLogFile
blk	Temporaryfile(WordPerfectforWin)
blob	SteamArchivefile
blt	SavedAIMBuddyListfile
bm	Bitmapgraphics
bmf	CorelImagefile
bmi	3dsmaxExecutable
bmk	HelpBookmarks(Windows3.x)
bmp	Bitmapgraphics(PCPaintbrush-many)
bmx	Buzzmusicfile
bnd	Typequickfile
bndl	Bundlefile
bnk	Adlibinstrumentbankfile
bob	BobDownDownloadingProgram
bom	MicroSimPCBoardBillofMaterials
boo	CompressedfileASCIIarchivecreatedbyBOO(msbooasm.arc)
book	AdobeFrameMakerBook
bot	Linkbotfile
box	MyriadJukeboxfile
bpc	Chart(BusinessPlanToolkit)
bpl	DelphiLibrary
bpt	Bitmapfillsfile(CorelDRAW)
bqy	BrioQueryfile
br	Script(Bridge)
brd	EagleLayoutfile
brf	BrailleASCIIfile
brk	Fax(BrooktroutFax-Mail)
brn	BornoSoftBangla2000(aBengaliwordprocessor)File
bro	TreeProfessionalBroadleafCreatorfile
brp	TreeProfessionalBroadleafCreatorimage
brt	MicrografxPicturePublisherfile
brx	Multimediabrowsingindex
bsa	CompressedfilearchivecreatedbyBSARC
bsb	MapInfoSeaChart
bsc	CompressedAppleIIfilearchivecreatedbyBINSCII
bsdl	BoundaryScanDescriptionLanguage
bsl	BSPlayerConfigurationfile
bsp	Half-life/TFC/CSMap
bst	BibTeXStylefile
bsv	BluespecSystemVerilogfile
bt!	BitTorrentPartialDownloadfile
btm	BatchToMemorybatchfile(4DOS)
btn	Buttonwarefile
bto	BaytexOrganix!2001LanguageKit
btr	BtrieveDatabasefile
btx	DB/TextWorksDatabaseTerm&Indexes
bud	QuickenBackup
bug	BugsandProblems
bun	BundledAudiofiles
bup	DVDBackupfile
but	Buttondefinitions(Buttons!)
buy	Datafileformat(movie)
bv1	OverflowfilebelowinsertpointinDoc1(WordPerfectfor
bv2	OverflowfilebelowinsertpointinDoc2(WordPerfectfor
bv3	OverflowfilebelowinsertpointinDoc3(WordPerfectfor
bv4	OverflowfilebelowinsertpointinDoc4(WordPerfectfor
bv5	OverflowfilebelowinsertpointinDoc5(WordPerfectfor
bv6	OverflowfilebelowinsertpointinDoc6(WordPerfectfor
bv7	OverflowfilebelowinsertpointinDoc7(WordPerfectfor
bv8	OverflowfilebelowinsertpointinDoc8(WordPerfectfor
bv9	OverflowfilebelowinsertpointinDoc9(WordPerfectfor
bwa	BlindWriteDiskImageInformationfile
bwb	Spreadsheetapplication(VisualBaler)
bwi	Blindread/Blindwrite
bwr	Beware(buglist)(Kermit)
bws	BlindwriteSubChannelDataFile
bwt	Blindread/Blindwrite
bxx	blaxxunContact
bz2	Bzip2UNIXCompressedfile
c	Csourcecodefile
c++	C++sourcecodefile
c--	Sourcecode(SphinxC--)
c00	Printfile(VenturaPublisher)
c01	Genesis2000
c2d	WinOnCDCDImage
c4d	MAXONCinema4DFile(Graphics)
c60	MidtronicsBatteryManagementSoftware
c86	Csourcecodefile(ComputerInnovationC86)
ca	Initialcachedataforrootdomainservers(Telnet)
cab	CabinetFile(Microsoftinstallationarchive)
cache	Cachefile(typicallyWebcache)
cad	SoftdeskDrafixCADFile
cac	dBASEIVexecutablewhencachingon/off(seecachedb.bat)
cad	Document(DrafixWindowsCAD)
cag	MSClipGalleryCatalogfile
cal	Calendarfile(Windows3.x)
calb	CoolectAlbumfile(CoolectAlbumPlayer)
cam	CasioCameraGraphic
can	Fax(NavigatorFax)
cap	Caption(VenturaPublisher)
car	AtHomeAssistantfile
cas	Comma-delimitedASCIIFile
cat	Catalog(dBASEIV)
cb	CleanBootFile(Microsoft)
cbc	Fuzzylogicsystem(CubiCalc)
cbf	CalendarBuilderfile
cbl	Cobolsourcecodefile
cbm	Compiledbitmapgraphics(XLib)
cbp	CentralBuilderProject
cbr	ComicBookReaderFilearchive(CDisplayimageviewer)
cbt	ComputerBasedTraining(many)
cbz	ComicBookReaderFilearchive(CDisplayimageviewer)
cc	C++sourcecodefile
cca	CC:Mailarchivefile
ccb	VisualBasicAnimatedButtonConfiguration
ccc	Bitmapgraphics(nativeformat)(CurtainCall)
ccd	CloneCDRelatedfile
cce	CalendarCreator2Eventfile
ccf	Communicationsconfigurationfile(Symphony)
cch	Chart(CorelChart)
ccl	CommunicationCommandLanguagefile(Intalk)
cco	BtxGraphicsfile(XBTX)
cct	MacromediaDirectorShockwavefile
ccx	CorelPrintHousefile
cda	CDAudioTrack
cdb	Carddatabase(CardScan)
cdd	ConceptDrawDocumentfile
cde	HoneywellHybridControlDesigner
cdf	ComponentDefinitionfile
cdg	CompactDiscPlusGraphicsfile
cdi	PhillipsCompactDiskInteractiveformat
cdk	Document(AtariCalamus)
cdl	CaseWareWorkingPapersDocumentLink
cdm	MediaMakerDiskImagefile
cdp	VisualObjectsDeveloperfile
cdr	Vectorgraphics(CorelDRAWnativeformat)
cdt	Data(CorelDraw4.0)
cdx	CorelDrawCompressedImagefile
ce	Main.ce(TheFarSideComputerCalendar)
ceb	ApabieBookfile
ceg	Bitmapgraphics(TempraShow-EdsunContinuousEdge
cel	Graphics(AutodeskAnimator-Lumena)
cf	SendmailConfigurationfile
cfb	Comptonsmultimediafile
cfc	MacromediaColdfusioncomponentextension
cfg	Configuration
cfl	Chart(CorelFLOW)
cfm	ColdFusionMarkupLanguage(Allaire)
cfn	Fontdata(AtariCalamus)
cfo	CFormObjectinternalformatobjectfile(TCUTurboC
cfp	QuickenCashFlowProjectionfile
cfr	CrossfireReplayfile
cga	CGAdisplayfont(VenturaPublisher)
cgd	CricketGraphDatafile
cge	CCDAstrocamera
cgi	CommonGatewayInterfacescript
cgm	ComputerGraphicsMetafilevectorgraphics(A&L-HG-
ch	Headerfile(Clipper5)
ch3	Chart(HarvardGraphics3.0)
ch4	Presentation(Charisma4.0)
chd	Fontdescriptor(FontChameleon)
chi	Document(ChiWriter)
chk	Recovereddata(ChkDsk)
chl	ConfigurationHistoryLog
chm	CompiledHTML
chn	Data(Ethnograph3)
cho	ChordProfile
chp	Chapterfile(VenturaPublisher)
chr	Characterset(TurboC-TurboPascal)
cht	Chart(HarvardGraphics2.0-SoftCraftPresenter)
chw	CompiledHelpIndexfile
cid	AnalogXCallerIDfile
cif	CaltechIntermediateFormatgraphics
ciff	CanonCIFF
cil	ClipGalleryDownloadPackage
cit	IntergraphRasterFileReference
cix	Databaseindex(TCUTurboCUtilities)
ckb	Keyboardmapping(BorlandC++4.5)
cl	CommonLISPsourcecodefile
cl3	EasyCDCreatorLayoutfile
cl4	EasyCDCreatorLayoutfile
cl5	EasyCDCreatorLayoutfile
class	Javaclassfile
clb	ICQContactList
clg	WindowsCatalogfile
cli	ClientManagementSystemCustomerfile
clm	COLIMOfile
clp	Clipartgraphics(QuattroPro)
clpi	Blue-rayDiscClipInformationfile
clr	Colorbinaryscreenimage(1stReader)
cls	C++classdefinitionfile
cm	Datafile(CraftMan)
cmd	Batchfile(OS/2)
cmf	FM-musicfile(CreativeMusicFile)
cmg	CMGfile
cmk	Card(CardShopPlus)
cml	COMALprogramminglanguage
cmm	Cmmscript(batch)file(CEnvi)
cmo	VirtoolsCompositionfile
cmp	HeaderfileforPostScriptprinterfiles(CorelDRAW)
cmq	Culturemetricsfile
cmt	Culturemetricsfile
cms	TrialDirectormediastorage
cmv	Animation(CorelMoveCorelDraw4.0)
cmx	CorelPhotoPaintImage
cnc	CNCgeneralprogramdata
cnd	ControlDrawfile
cnf	Configuration(program-printersetup)
cnt	Helpfilecontents
cnv	Dataconversionsupportfile(WordforWindows)
cob	Cobolsourcecodefile
cod	Datafile(ForecastPlus-MSMultiplan-StatPacGold)
col	Colorpalette(AutodeskAnimator-many)
com	Command(memoryimageofexecutableprogram)(DOS)
con	Configurationfile(Simdir)
conf	Configurationfile
config	Configurationfile
cor	ProteinStructurefile
cpd	Script(ComplaintsDesk)
cpe	MSFaxCoverSheet
cpf	Fax(TheCompleteFax)
cph	CorelPrintHouseimage
cpi	CodePageInformationfile(DOS)
cpl	Controlpanelfile(Windows3.x)
cpo	CorelPrintHousefile
cpp	C++sourcecodefile
cpr	CubaseProjectfile
cps	BackupofstartupfilesbyCentralPointPCTools
cpt	CompressedMacfilearchivecreatedbyCOMPACTPRO
cpx	ControlPanelApplet
cpy	CopyBooksDatafile
cpz	Musictextfile(COMPOZ)
cr2	CanonRawImagefile
crc	TotalCommanderCRCfile
crd	Cardfile(Windows3.x-YourWay)
crf	Cross-reference(MSMASM-ZortechC++)
crh	LinksGamesCoursefile
crp	Encrypteddatabase(dBASEIV)
crs	FileConversionResource(WordPerfect5.1)
crt	Terminalsettingsinformation(Oracle)
crtr	Multi-AdCreator7document
crtx	MicrosoftChartTemplatefile
cru	CompressedfilearchivecreatedbyCRUSH
crw	CanonRAWImagefile
crx	ChromeExtensionfile
crz	LinksGamesCoursefile
cs	VisualC#Sourcefile
csa	CommaDeliminatedText
csf	AdobeColourSettingsfile
csg	Graph(Statistica/w)
csh	HamiltonLabsCShellScriptfile
csk	ClarisWorks
csm	Precompiledheaders(BorlandC++4.5)
cso	CompressedISOImagefile
csp	PCEmceeScreenImagefile(ComputerSupportCorporation)
css	CascadingSheetStylefile
cst	MacromediaDirectorCastfile
csv	CommaSeparatedValuestextfileformat(ASCII)
ct	ContinousTonefile
ctc	Controlfile(PCInstaller)
ctd	CobraTrackDump
ctf	Charactercodetranslationfile(Symphony)
ctg	CanonCatalogfile
ctl	MicrosoftVisualBasicControlfile
ctn	CADTERNSfile
ctt	Messengercontactsfile
ctu	CZTU,agamma-rayanalysisprogram.NeedtheCTZU.exefile
ctx	CourseTeXtfile(Microsoftonlineguides)
cty	SimCityCityfile
cue	MSCueCardsdata
cuf	CUtilitiesFormdefinition(TCUTurboCUtilities)
cul	Windowscursorlibrary(IconForge,ImageForge,ImageForge
cur	Cursorimagefile(Windows3.x)
cut	Bitmapgraphics(Dr.Halo)
cv4	Colorfile(CodeView)
cv5	Canvasversion5
cva	ACDCanvasSequenceSetfile
cvb	BorlandBDEFile
cvd	Bitdefender
cvp	Coverpage(WinFax)
cvr	WinFaxCoverSheet
cvs	Graphics(Canvas)
cvt	BackupfileforCONVERTeddatabasefile(dBASEIV)
cvw	Colorfile(CodeView)
cwk	ClarisWorksdata
cwz	CropWalkerfile
cxf	GooglePicasaCollagefile
cxp	CoreMediaPlayerXML-basedPlaylistFile
cxt	MacromediaDirectorProtectedCastfile
cxx	C++sourcecodefile(ZortechC++)
d	Dprogramminglanguagesourcecode
d00	BlasterMasterProFile
d10	H&RBlockDeductionProfile
d2s	Characterfile(Diablo2)
d3d	FileExtensionforDesktop-3DNotes
d64	Commodore64EmulatorDiskImage
dat	DatafileinspecialformatorASCII
data	SidTuneaudiofile
day	Journalfile
db	Configuration(dBASEIV-dBFast)
db$	Temperaturedebuginfo(ClarionModula-2)
db2	Database(dBASEII)
db3	Database(dBASEIII)
dba	Datafile(DataEase)
dbb	ANSYSDatabaseBackup
dbd	Businessdata(BusinessInsight)
dbf	Databasefile(dBASEIII/IV-FoxPro-dBFast-DataBoss)
dbg	Symbolicdebugginginformation(MSC/C++)
dbk	Databasebackup(dBASEIV)
dbl	WindowsXPActivationfile
dbm	Datafile(DataEase)
dbo	Compiledprogram(dBASEIV)
dbs	DatabaseinSQLWindowsformat
dbt	DataBaseText(Clipper)
dbw	Windowsfile(DataBoss)
dbx	Database
dca	DocumentContentArchitecturetextfile(IBMDisplayWrite)
dcf	Diskimagefile
dcm	DCMModuleFormat
dcp	DataCodePage(OS/2)
dcr	KodakProprietaryImageFormat
dcs	Bitmapgraphics(CYMKformat)(QuarkXPress)
dct	Databasedictionary(ClarionDatabaseDeveloper)
dcx	FAXImage
dd	CompressedMacintoshfilearchivecreatedbyDISKDOUBLER
ddat	DivXTemporaryfile
ddb	Bitmapgraphics
ddc	DivXDescriptorDescriptionFile
ddf	MSDataDefinitionLanguagefile
ddi	DiskdupeImagefile(ddupe322.zip)
ddp	DeviceDriverProfilefile(OS/2)
de	MetaProductsDownloadExpressincompletelydownloadedfile
de7	DanceEjay7File
deb	Debugscript(DOSDebug)
dec	VersaProDeclarationfile
def	Assemblyheaderfile(Geoworks)
dem	Demonstration
des	DescriptionText
dev	Devicedriver
dfd	DataFlowDiagramgraphic(Prosa)
dff	CriterionRenderWare3.x3Dobjectformat
dfi	Outlinefontdescription(Digifont)
dfl	Defaultprogramsettings(Signature)
dfm	DataFlowDiagrammodelfile(Prosa)
dfs	DelightSoundfile
dft	Fakt2000file
dfv	Printingform(Word)
dfx	Drafixfile
dgn	Graphics(MicroStation)
dgr	FaxPage(MSOutlookExpress)
dgs	Diagnostics
dh	Dependencyinformationfor.ph(Geoworks)
dhp	Dr.HaloPICFormatgraphics(Dr.HaloII-III)
dht	Datafile(Gauss)
dhy	AdobeBridgefile
dia	Diagraphgraphics(ComputerSupportCorporation)
dib	Bitmapgraphics(Device-IndependentBitmap)
dic	LotusNotes/Dominodictonaryfile
dif	Database(VisiCalc)
dig	DigilinkFormat
dip	Graphics
dir	AdobeDirectorMovieFile
dis	DATAIRdataimportspecificationfile
divx	DivXEncodedMoviefile
diz	Descriptionfile(DescriptionInZip)
dje	MattBattiAM-player
djv	DJVuScannedfile
djvu	DJVufile
dkb	Raytracedgraphics(DKBTrace)
dl	Animation(Italianorigin)
dl_	Compressed.dllfileinanInstallArchive
dld	Data(Lotus1-2-3)
dlg	Dialogresourcescriptfile(MSWindowsSDK)
dll	DynamicLinkLibrary(Windows3.x-OS/2)
dls	Setup(NortonDisklock)
dmf	Delusion/XTrackerdigitalmusicfile
dmg	MacintoshOSXDiskImagefile
dml	MedicalManagerDMLSystemScript
dmo	Demo(Derive)
dmp	Dumpfile(eg.screenormemory)
dms	CompressedAmigafilearchivecreatedbyDISKMASHER
dmsk	DivXWebPlayerTemporaryfile
dna	DesktopDNAdatastoragefile
dnasym	DesktopDNAcompiledapplicationscript
dnax	DesktopDNAexclusionlist(text)
dne	NeticaBayesnetfile(NorsysSoftwareCorp.)
dng	AdobeDigitalNegativefFile
dnl	DigitalWebBookElectronicBook
do	ModelSimFilterDesignHDLCoder
doc	Documenttextfile
docm	OpenXMLMacro-enabledDocumentfile(MicrosoftWord2007/
docx	OpenXMLDocumenttextfile(MicrosoftOffice2007/Office
dog	Screenfile(LaughingDogScreenMaker)
doh	Dependencyinformationfor.poh(Geoworks)
dol	NintendoExecutablefile
dos	Externalcommandfile(1stReader)
dot	Line-typedefinitionfile(CorelDRAW)
dotx	MicrosoftWord2007/Word2010Templatefile
dox	Textfile(MultiMate4.0)
doz	DescriptionOutofZip(VENDINFO)
dp	Calendarfile(DailyPlanner)
dpg	NintendoDSMPEGVideoFile
dpk	DelphiPackagefile
dpp	SerifDrawPlusDrawing
dpr	Defaultproject-andstate-relatedinformation(Borland
dps	DivXPlayerSkinfile
dpt	DesktopDNAtemplate
dpx	Digitalmovingpictureexchangeformat
dra	MapMakerProGISvectorlayer
drs	DisplayResource(WordPerfectforWin)
drv	Devicedrivereg.forprinter
drw	Drawing(various)
ds	TwainDataSourcefile
ds4	Vectorgraphics(MicrografxDesigner4.0)
dsa	DasyTecDASYLabfile
dsb	DasyTecDASYLabfile
dsc	Discardfile(Oracle)
dsd	Database(DataShaper)
dsf	MicrografxDesigner
dsk	Projectdesktopfile(BorlandC++-TurboPascal)
dsm	Digitalsoundmodule(DSI)
dsn	ODBCDataSourcefile
dsp	Displayparameters(Signature)
dsp2	ReaderXandDragonStarProLtdfileextensions
dsr	DriverResource(WordPerfectforWin)
dss	Screensaverfile(DCC)
dst	PC-RDistDistributionfile
dsw	Desktopsettings(BorlandC++4.5)
dsy	PCDraftSymbolLibrary
dt_	DataforkofaMacintoshfile(Mac-ette)
dta	Datafile(TurboPascal-PC-File-Stata)
dtd	SGMLDocumentDefinitionfile
dtf	Databasefile(PFS-Q&A)
dtp	Document(TimeworksPublisher3)
dup	DuplicateBackup
dus	Readirisfontdictionary
dvc	Data(Lotus1-2-3)
dvf	DVStudioCamcorderGraphicsfile
dvi	DeviceIndependentdocument(TeX)
dvp	DesqviewProgramInformationfile(DESQview)
dvr	WindowsMediaCenterRecordedfile
dvr-ms	filescreatedbyStreamBufferEngine(SBE)
dw2	Drawing(DesignCADforwindows)
dwc	CompressedfilearchivecreatedbyDWC(dwc-a501.exe)
dwd	DavkaWriterfile
dwf	AutodeskWHIP!DrawingWebfile
dwg	Drawing(Drafix)
dwk	DADiSPWorksheetFile
dwl	DrawingLockfile
dwt	AutoCADTemplate/Prototypefile
dwz	DVDmovieFactory3
dx	Textfile(DECWPS/DXformat-DECWPSPlus)
dxf	DrawingInterchangeFileFormatvectorgraphics(AutoCAD)
dxn	Fax(FujitsudexNET)
dxr	AdobeDirectorMovieFile
dyc	ICUIIVideochatfile
dylib	Appleosxextensionforlib
dyn	Data(Lotus1-2-3)
dz	DzipCompressedfile
e3p	CIM-TeamE3.seriespartsfile
e3s	CIM-TeamE3.seriesprojectfileformat
e3t	CIM-TeamE3.seriestemplatefile
e3v	CIM-TeamE3.seriesviewerprojectfileformat
eap	EnterpriseArchitectProjectfile
ear	JavaEnterpriseApplicationPackagingUnit
eas	EliteVisualBasicAPISpy
ebj	Error-checkingobjectfile(Geoworks)
ebo	MSReaderEbookFormat
ebp	PocketPCWindowsCEProjectfile
ecf	MicrosoftOutlookAdd-onfile
eco	NetManageECCOfile
ecw	EnsoniqWavesetFormat
edb	MSExchangeDatabase
edl	EditDecisionList(managementforvideo/filmpost
edr	Portableenergyfile-GROMACS3.3
eds	EnsoniqSQ80diskimage
edt	Defaultsettings(VAXEdteditor)
eeb	ButtonbarforEquationEditor(WordPerfectforWin)
efe	EnsoniqEPSfile
eft	Highresolutionscreenfont(ChiWriter)
efx	Fax(EverexEFax)
ega	EGAdisplayfont(VenturaPublisher)
ek5	SonarDataEchoviewfile
ek6	SonarDataEchoviewfile
ekm	EXP:TheScientificWordProcessorMacro
el	Elispsourcecodefile(Emacslisp)
elc	CompiledELISPcode(Emacslisp)
elm	MSFrontPageTheme-Packfile
elt	Eventlisttextfile(Prosa)
email	OutlookExpressMailMessage
emb	EverestEmbeddedBankFile
emd	ABTExtendedModule
emf	EnchancedMetafilegraphics
eml	ElectronicMail(Email)Messagefile
emp	E-MusicFileFormat
ems	PCToolsEnhancedMenuSystemConfig
emu	Terminalemulationdata(BITCOM)
emx	Ensuredmailencryptedfile/e-mailmessage
emz	WindowsCompressedEnhancedMetafile
enc	Encodedfile-UUENCODEdfile(Lotus1-2-3-uuexe515.exe)
end	Arrow-headdefinitionfile(CorelDRAW)
eng	Dictionaryengine(Sprint)
ens	EndNoteStylesfile
env	Envelopermacro(WOPR)
eot	MSWEFTEmbeddedOpenTypefile
epd	Publication(ExpressPublisher)
epf	EncryptionProtection(encryptedfileformat)
epi	Document(ExpressPublisher)
epp	EditPadProProject
eps	EncapsulatedPostScriptvectorgraphics(AdobeIllustrator)
epub	OpenElectronicBookfile
eqn	Equation(WordPerfectforWin)
erd	EntityRelationshipDiagramgraphicfile(Prosa)
erm	EntityRelationshipDiagrammodelfile(Prosa)
err	Errorlog
esp	Venturafile
esh	ExtendedShellbatchfile
esl	MSVisualFoxProDistributableSupportLibrary
ess	EXP:TheScientificWordProcessorStyleSheet
est	MSStreets&Trips2001Tripfile
etf	EnrichedTextfile
eth	Document(Ethnograph3)
ets	eSignalTimeandSalesfile
etx	StructureEnhanced(setext)text
ev	SonarDataEchoviewfile
evi	SonarDataEchoviewfile
evl	SonarDataEchoviewfile
evr	SonarDataEchoviewfile
evt	Eventlog
evy	Document(WordPerfectEnvoy)
ewd	Document(ExpressPublisherforWindows)
ewl	EclipseCrosswordWordList
ex	NortonGhostTemplateFile
ex_	Compressed.EXEFileinanInstallArchive
ex3	Devicedriver(HarvardGraphics3.0)
exc	Rexxsourcecodefile(VM/CMS)
exd	ControlInformationCache
exe	Directlyexecutableprogram(DOS)
exm	Msdosexecutable,system-managercompliant(HPcalculator)
exp	ICQSavedChatfile
ext	Extensionfile(NortonCommander)
ext2fs	filesystemdriverintheLinuxkernel
exx	IntermediatefilebyMsgPut(IBMLinkWay)
ezf	Fax(CalculusEZ-Fax)
ezm	Textfile
ezp	EdifyElectronicWorkforceBackupUtility
ezz	eZBackupbackupfile
f	Fortransourcecodefile
f_i	PrintIPSfile
f01	Fax(perfectfax)
f06	Dosscreentextfont-height6pixels(fntcol13.zip)
f07	Dosscreentextfont-height7pixels(fntcol13.zip)
f08	Dosscreentextfont-height8pixels(fntcol13.zip)
f09	Dosscreentextfont-height9pixels(fntcol13.zip)
f10	Dosscreentextfont-height10pixels(fntcol13.zip)
f11	Dosscreentextfont-height11pixels(fntcol13.zip)
f12	Dosscreentextfont-height12pixels(fntcol13.zip)
f13	Dosscreentextfont-height13pixels(fntcol13.zip)
f14	Dosscreentextfont-height14pixels(fntcol13.zip)
f16	Dosscreentextfont-height16pixels(fntcol13.zip)
f2	FLASHBIOSfile
f2r	Linearmodule(music)(Farandole)
f3r	Blockedmodule(music)(Farandole)
f4v	MP4Videofile
f77	Fortran77sourcecodefile
f90	Fortranfile
f96	Fax(FrecomFAX96)
fac	Facegraphics
faq	FrequentlyAskedQuestionstextfile
far	FarandoyleTrackerMusicModule
fav	MSOutlookBarShortcuts
fax	Fax(rastergraphics)(mostFaxprograms)
fbc	FamilyTreeCompressedbackupfile
fbk	NavisonFinancialsBackup
fc	Spellcheckingdictionary(HarvardGraphics2.0)
fcd	VirtualCD-ROM
fcm	Binaryfilepatchfile(forwardcompression)(jlpak10.zip)
fcp	FLAMESCheckpointRestartfile(Ternion)
fcs	FlowCytometryStandardFormat
fcw	CampaignCartographer2file
fd	Declarationfile(MSFortran)
fdb	ArtExplosionPortfolioCatalogfile
fde	FLAMESDatasetExportfile(Ternion)
fdf	AdobeAcrobatFormsdocument
fdr	FinalDraftDocumentfile
fdw	Form(F3DesignandMapping)
feb	ButtonbarforFigureEditor(WordPerfectforWin)
fef	Steuer2001file
fes	FabioEditingSoftware
fev	FLAMESEnvironmentVariablefile(Ternion)
ff	Outlinefontdescription(AgfaCompugraphics)
ffa	MSFastFindfile
fff	Fax(defFax)
ffl	MSFastFindfile
ffo	MSFastFindfile
fft	Dca/FFTFinalFormTexttextfile(DisplayWrite)
ffx	MicrosoftFastFindfile
fgd	FolderGuardData
fh3	Vectorgraphics(AldusFreeHand3.x)
fh4	Vectorgraphics(AldusFreeHand4.x)
fh5	Freehand5
fh6	Freehand6
fh7	Freehand7
fh8	MacromediaFreehand8
fh9	MacromediaFreehand9
fh10	MacromediaFreehand10
fi	Interfacefile(MSFortran)
fif	FractalImageFormatfile
fig	REND386/AVRILGraphic
fil	Filetemplate(ApplicationGenerator)
fin	Print-formattedtextfile(PerfectWriter-Scribble-
fio	PhotoStylergraphics(filter)
fit	Fitsgraphics
fix	Patchfile
fky	Macrofile(FoxPro)
fla	AdobeFlashfile
flac	FreeLosslessAudioCodec
flb	Formatlibrary(Papyrus)
flc	Animation(AutodeskAnimator)
fld	Folder(Charisma)
fle	Fleaprogram:outboundfileandattachmentrequiredbythe
flf	CorelParadoxForm
fli	Texfontlibrary(EmTeX)
flk	FileLockerEncryptedfile
flm	FilmRoll(AutoCAD/AutoShade)
flo	MicrografxFlowCharter
flp	AdobeFlashProjectfile
flt	AsymetrixGraphicsFilterSupportfile
flv	AdobeFlashVideofile
flx	Compiledbinary(DataFlex)
fm	Spreatsheet(FileMakerPro)
fm1	Spreadsheet(Lotus1-2-3release2.x)
fm3	Devicedriver(HarvardGraphics3.0)
fmb	FileManagerButtonbar(WordPerfectforWin)
fmf	Fontoriconfile(IBMLinkWay)
fmg	FreeMarketsGraphicsBrowser
fmk	Makefile(FortranPowerStation)
fmo	Compiledformatfile(dBASEIV)
fmp	FileMakerProDocument
fmpp	FLAMESModelPrototypefileforcomponentswritteninC++
fmt	Formatfile(dBASEIV-FoxPro-Clipper5-dBFast)
fmv	FrameVectorMetafile
fmz	FormZProgramfiles(drawingprogram)
fn3	Fontfile(HarvardGraphics3.0)
fnt	Fontfile(many)
fnx	Inactivefont(Exact)
fo1	Fontfile(BorlandTurboC)
fo2	Fontfile(BorlandTurboC)
fol	Folderofsavedmessages(1stReader)
fon	Dialingdirectoryfile(Telix)
for	Fortransourcecodefile
fot	InstalledTruetypefont(WindowsFontInstaller)
fp	Configurationfile(FoxPro)
fp3	FileMakerPro3.0andearlierfiles
fp4	FileMakerPro4.0
fp5	FileMakerPro5.0andlaterfiles
fpb	FLAMESPlaybackRecorderfile(Ternion)
fpc	Catalog(FoxPro)
fpk	JetFormFormFlowfile
fpr	FLAMESPrototypefile(Ternion)
fpt	Memo(FoxPro)
fpw	Floorplandrawing(FloorPLANplusforWindows)
fpx	FlashPixBitmap
fqy	FLAMESFLARECommandfile(Ternion)
fr3	RenameddBASEIII+formfile(dBASEIV)
frc	FLAMESRecorderOutputfile;FLAREInputfile(Ternion)
frd	Fileswhichcontainloudspeakerfrequencyresponsedata
fre	CreativeDigitalBlasterDigitalVCRfile
frf	Font(FontMonger)
frg	Uncompiledreportfile(dBASEIV)
frl	FormFlowfile
frm	MySQLDatabaseFormatfile
fro	Compiledreportfile(dBASEIV)
frp	Form(PerFormPROPlus-FormFlow)
frs	ScreenFontResource(WordPerfectforWin)
frt	Reportmemo(FoxPro)
frx	Report(FoxPro)
fs	F#SourceCodefile
fsc	FLAMESScenariofile(Ternion)
fsh	EASportsGameGraphicEditorfile
fsl	Form(ParadoxforWindows)
fsm	FarandoyleSampleformatmusic
fst	Linkableprogram(dBFast)
fsproj	StoreFirestarterprojectsusedtogenerateclass
fsx	Data(Lotus1-2-3)
fsy	Fileware'sFilesync
ftm	Fontfile(Micrografx)
fts	WindowsHelpFull-TextSearchIndexfile
ftw	Familyfile
ftp	Configuration(FTPSoftwarePC/TCP)
fus	FilesthatstoreusersettingsforvariousFLAMES
fvt	InterlockPublicComputerUtility
fw	Database(FrameWork)
fw2	Database(FrameworkII)
fw3	Database(FrameworkIII)
fwp	FLAMESWindowViewerprojectfile(Ternion).
fx	DirectXEffectsfile
fxd	Phonebook(FAXit)
fxm	WinFax/WinFaxMiniViewerFax
fxo	FaxImageDocument
fxp	Compiledformat(FoxPro)
fxr	WinFaxReceivedDocument
fxs	FaxTransmitFormatgraphics(WinFax)
g	Datachart(APPLAUSE)
g3	Group3Faxdocument;Group3Fax
g3f	ZetafaxTIFFfile(fineresolution)
g3n	ZetafaxTIFFfile(normalresolution)
g8	Rawgraphics(onebyteperpixel)planethree(PicLab)
gab	GlobalAddressBookfile
gal	CorelMultimediaManagerAlbum
gam	SavedGamefile
gat	Gatorfile
gb	PagefoxBitmapImagefile
gba	GameBoyAdvancedROM
gbc	GameBoyCOlorROM
gbd	GatorBannerfile
gbl	Globaldefinitions(VAXTPUeditor)
gbr	GIMPBrushfile
gbx	Gerberfile
gc1	Lispsourcecode(GoldenCommonLisp1.1)
gc3	Lispsourcecode(GoldenCommonLisp3.1)
gcd	Graphics
gcf	SteamGCFFile
gdb	InterbaseDatabase
gdf	Dictionaryfile(GEOS)
gdr	BitmapFontfile(SymbianOS)
ged	Editor'snativefileformat(Arts&Letters)
gem	Vectorgraphics(GEM-VenturaPublisher)
gen	Compiledtemplate(dBASEApplicationGenerator)
geo	Geode(Geoworks)
gfb	CompressedGIFimagecreatedbyGIFBLAST(gifblast.exe)
gft	Font(NeoPaint)
gfx	GenigraphicsGraphicsLinkPresentation
gg	GoogleDesktopGadgetfile
gho	SymantecGhostDiskimagefile
ghs	LasertankHighScores
gib	Chart(Graph-in-the-Box)
gid	WindowsHelpindexfile
gif	GraphicsInterchangeFormatbitmapgraphics(CompuShow)
gig	Soundfile
giw	Presentation(Graph-in-the-BoxforWindows)
gl	Animation(GRASPGRAphicalSystemforPresentation)
glm	Datafile(Glim)
gls	Datafile(Across)
gly	Glossary(MSWord)
gmd	GameMakerfileformat
gmf	CGMgraphics(APPLAUSE)
gml	GeographyMarkupLanguagefile
gmp	Geomorphtilemap(SPX)
gno	GenoproGenealogyDocumentfile
gnt	InMFCOBOLacompiled.cblfile
goc	Gocsourcecodefile(Geoworks)
goh	Gocheaderfile(Geoworks)
gp	Geodeparameterfile(GeoworksGlue)
gp3	CCITTGroup3file
gp4	GuitarProversion4.06
gpd	VISUALEPRInputDataforPARAMS.EXE
gph	Graph(Lotus1-2-3/G)
gpk	Omnigoprogrampackage
gpx	GPSeXchangeFormat
gr2	Screendriver(Windows3.x)
gra	Datafile(SigmaPlot)
grb	Ms-DOSShellMonitorfile(MS-DOS5)
grd	GradebookPowerfile
grf	MicrografixImagefile
grl	MatlabGraphicFormat
grp	Groupfile(Windows3.x-Papyrus)
grx	Filelist(GetRight)
gry	RawGREYgraphics
gs1	Presentation(GraphShow)
gsd	Vectorgraphics(ProfessionalDraw)
gsm	RawGSM6.10AudioStream
gsp	Geometer'sSketchpadMaterialfile
gsw	Worksheet(GraphShow)
gtp	GnomeDesktopThemefile
gts	GenomeSoftwareTempoAlarmClock
gup	Data(PopMail)
gwi	GroupwiseFile
gwp	GreetingsWorkShopfile
gxd	GeneralCADDProfile
gxl	Graphicslibrary(Genus)
gxt	GTA2Gamefile
gym	SegaGenesisMusicLoggedFormat
gz	CompressedfilearchivecreatedbyGZIP(GNUzip)
gzip	CompressedfilearchivecreatedbyGZIP(GNUzip)
h	Headerfile
h!	On-linehelpfile(FlambeauxHelp!DisplayEngine)
h++	Headerfile(C++)
h--	Headerfile(SphinxC--)
ha	CompressedfilearchivecreatedbyHA(ha098.zip)
ham	Imagefile
hap	CompressedfilearchivecreatedbyHAP(hap303re.zip)
hbk	Handbook(Mathcad)
hbs	eBerryTransparentAnimation-compressedbitmapfiles
hcr	IBMHCD/HCMProductionConfiguration
hdf	HierarchicalDataFilegraphics(SDSCImageTools)
hdl	Alternatedownloadfilelisting(ProcommPlus)
hdp	HDPhotoFile
hdr	InstallShieldSetupheader
hds	WindowsDigitalRightManagementfile
hdw	Vectorgraphics(HarvardDraw)
hdx	Helpindex(AutoCAD-ZortechC++)
hed	HighEditdocument
hex	Hexdump
hfi	HpFontInfofile(GEM)
hfx	HotFaxfile
hgl	HpGraphicsLanguagegraphics
hh	C++headerfile
hhc	TableofContentsfile
hhh	Precompiledheaderfile(PowerC)
hhk	HelpWorkshopIndexfile
hhp	Helpinformationforremoteusers(ProcommPlus)
hht	MSMessengerfile
hin	Molecule(HyperChem)
his	InsightIIDynamicsTrajectoryHistoryfile
hlb	Helplibrary(VAX)
hlp	Helpinformation
hlz	Multi-EditPackedHelpfile
hm3	Help&Manual3projectFormat
hmm	AlternateMailReadoptionmenu(ProcommPlus)
hnc	CNCprogramfilesHeidenhain(?)dialog
hof	HallOfFame(gamescores)
hp8	AsciitextHPRoman8characterset(NewWaveWrite)
hpf	HpLaserJetfonts(PageMaker)
hpg	HPGLplotterfilevectorgraphics(AutoCad-Harvard
hpi	Fontinformationfile(GEM)
hpj	Helpproject(MSHelpCompiler)
hpk	CompressedfilearchivecreatedbyHPACK(hpack75.zip)
hpm	Emmtext(HPNewWave)
hpp	C++headerfile(ZortechC++)
hqx	CompressedMacintoshASCIIarchivecreatedbyBINHEX
hrf	Graphics(HitachiRasterFormat)
hrm	AlternateMainmenuforlimited/normalusers(ProcommPlus)
hs2	Monochromeimage(Postering)
hsi	HandmadeSoftwareInc.graphics-almostJPEG(Image
hst	YahooMessengerHistoryfile
hta	Hypertextapplication
htc	HTMLComponent(mechanismforimplementingDynamicHTMLin
htf	WebBaseFile
hti	WebBaseFile
htm	HyperTextMarkupLanguagedocument
html	HyperTextMarkupLanguagedocument
htr	MotionAnalysisSoftwareSkeletalfile
htt	Hypertexttemplate
htx	Hypertextfile
hus	HusqvarnaDesignerIEmbroideryMachineFormat
hwd	Presentation(Hollywood)
hxm	AlternateProtocolSelectionmenuforallusers(Procomm
hxx	C++headerfile
hy1	Hyphenationalgorithms(VenturaPublisher)
hy2	Hyphenationalgorithms(VenturaPublisher)
hyc	Data(WordPerfect)
hyd	Hyphenationdictionary(WordPerfectforWin)
hyp	CompressedfilearchivecreatedbyHYPER(hyper25.zip)
hyt	VFSMODProjectoutputfile
i	Intermediatefile(BorlandC++4.5)
iaf	MSOutlook97and2000e-mailaccountsettings
iax	Bitmapgraphics(IBMImageAccesseXecutive)
ibm	CompressedfilearchivecreatedbyARCHDOS(InternalIBM
ibd	InstallerDialogResourcefile
ibp	IsobusterImagefile
ibq	IsobusterManagedImagefile
ica	Bitmapgraphics(ImageObjectContentArchitecture)
icb	Bitmapgraphics
icc	KodakPrinterImage
icd	IronCAD2DCADfile
icl	Iconlibrary(ActivIcons,IconForge,ImageForge,ImageForge
icm	ImageColorMatchingProfilefile
icn	Iconsourcecodefile
ico	Icon(Windows3.x)
ics	iCalendarCalendarfile
id	Diskidentificationfile
id2	WindowsLiveMessengerEmoticonfile
idb	DatabaseUsedbyDisassembler
ide	Project(BorlandC++4.5)
idf	ARTiSANReal-timeStudioIDfile
idl	MSVisualC++InterfaceDefinitionfile
idw	Vectorgraphics(IntelliDraw)
idx	Index(many-FoxPro)
ies	Photometricfiledata
ifd	Form(JetFormDesign)
iff	InterchangeFileFormatbitmapgraphics/sound(Amiga)
ifo	Savedgraphicobjects(ImageForgePRO)
ifp	Script(KnowledgeMan)
ifs	Fractalimagecompressedfile(Yuvpak)
igr	IntergraphSmartSketchDrawing
igs	IGES-Format
igx	iGrafxProcess
iif	QuickBooksforWindowsInterchangefile
ilb	Data(ScreamTracker)
ilk	Outlineofprogram'sformat(MSILinkincrementallinker)
im30	SunRasterimagefile
im8	Sunrastergraphics
ima	Miragevectorgraphics(EGO,Chart,Autumn)
imb	IncrediMailfile
imc	IncrediMailfile
imd	CasewareIDEA(GISdatafile)
imf	ImageForge/IconForgesavedfilteredbrushes(IconForge,
img	Bitmapgraphics(VenturaPublisher-GEMPaint)
imm	IncrediMailTrash
imn	IncrediMailNotifier
imp	Spreadsheet(LotusImprov)
imq	Imagepresentation(ImageQ)
ims	IncredimailGraphic
imv	YahooInstantMessengerIMVironment
imw	ImagewareSurfacer3DCADSurfaceGeometry
imz	Compressedfloppyimage
in$	Installationfile(HPNewWave)
in3	Inputdevicedriver(HarvardGraphics3.0)
inb	Testscript(VermontHighTest)
inc	Includefile(severalprogramminglanguages)
ind	Index(dBASEIV)
indd	AdobeInDesignfileformat
inf	Type1LaserJetfontinformationfile(softfont
ini	Initializationfile
ink	Pantonereferencefillsfile(CorelDRAW)
inl	MSVisualC++InlineFunctionfile
inp	GISSoftwareTextInputfile
ins	Data(WordPerfect)
int	BorlandInterfaceUnits
inv	RogueSpearInventoryfile
inx	FoxproIndex(Foxbase)
io	CompressedfilearchivecreatedbyCPIO
iob	3dgraphicsdatabaseinTDDDformat
ioc	Organizationalchart(InstantORGcharting!)
ion	4dosdescript.ionfile(filedescriptions)
ipa	iPod/iPhoneApplicationfile
ipd	BlackBerryBackupfile
ipg	MindjonggFormat
ipj	ImpaticaOnCueProjectfile
ipl	PantoneSpotreferencepalettefile(CorelDRAW)
ipp	Help&ManualProprietaryImage
ips	GamePatchfile
ipsw	IPod/IPad/IPhoneSoftwarefile
ipx	IPIXAVfile
ipz	ICQSkinPlus
iri	IRImagefile
irs	Resource(WordPerfect)
isd	SpellingCheckerdictionary(RapidFile)
ish	CompressedfilearchivecreatedbyISH
isk	Commandfile
iso	EasyCDCreatorDiscImage
isr	MSStreets&TripsRoutefile
iss	InstallShieldResponsefile
ist	DigitrakkerInstrumentFile(n-FaCToR)
isu	InstallShieldUninstallScript
isz	Anextensionon.ISOthatallowscompressionandsplitting
it	Settings(intalk)
itc2	iTunesAlbumDatafile
itdb	iTunesDatabasefile
itf	Interfacefile(JPITopSpeedPascal)
ith	InTethertechnologysecuredfile
itl	MusicLibraryfile
iv	OpenInventorfiles(thesuccessortoInventor)
iva	securityvideodatafile
ivt	MSInfoviewerTitle
iw	Presentationflowchart(IconAuthor-HSCInterActive)
iwa	Textfile(IBMWritingAssistant)
iwd	CallofDutyGameDatafile
iwp	Textfile(Wang)
izt	Izlbinarytokenfile(IZL)
j01	FileExtensionfromADPPayrollCompany
jad	JavaApplicationDescriptorextension(forinstalling
jar	Javaarchivefile
jas	Graphics
jav	Javasourcecodefile
java	Javasourcecodefile
jbc	JamByte-CodeHexfile
jbd	Datafile(SigmaScan)
jbf	PaintShopProbrowserfile
jbk	JunoBackupfile
jbr	JascPaintShopProBrush
jbx	Projectfile(ProjectScheduler4)
jdt	AccelioCaptureClassicFiller
jef	JanomeNH10000SewingMachinefile
jet	Fax(HybridJetFax)
jff	Bitmapgraphics(JPEGFileInterchangeFormat)
jfif	JPEGimage
jfx	J2FaxFile
jhtml	DynamoServerPage
jif	JPEG/JIFFImage
jmx	JMeterfile
jnb	SigmaPlotWorkbookfile
jnl	IngresJournalfile
jnlp	JavaWebStartfile
jnt	WindowsJournalNotefile
job	Jobfile
jor	JournalfileSQL
jou	Journalbackup(VAXEdteditor)
jp2	JPEG2000file
jpc	Graphics(JapanPIC)
jpeg	JPEGimage
jpf	JPEG2000file
jpg	Bitmapgraphics(JointPhotographyExpertsGroup)
jps	StereoImage
jpx	JBuilderProjectfile
js	MicrosoftScriptingLanguage"JScript"fileextension
jsd	eFAXJetSuiteDocument
jse	JScriptEncodedScriptfile
jsf	FireworksBatchScriptfile
jsh	Henter-Joyce,Inc.JawsScriptHeaderfile
json	JavaScriptObjectNotationfile
jsp	JavaServerpage
jtf	Fax(HayesJTFax)
jtp	Jetformfile
jup	(NewPlanetSoftware)CodeCrusaderuser'sproject
jw	Textdocument(JustWrite)
jwl	Library(JustWrite)
jwp	EasyCDCreatorLabelfile
jxr	JPEGXRfile
jzz	Spreadsheet(Jazz)
kar	Midifilewithkaraokewordtrack
kau	SassafrasKeyAuditAuditfile
kb	Keyboardscript(BorlandC++4.5)
kbd	Keyboardmapping(LocoScript-Signature-ProcommPlus)
kbm	Keyboardmapping(Reflection4.0)
kcl	Lispsourcecode(KyotoCommonLisp)
kcp	Keychampfile
kdc	KasperskyVirusDatabasefile
keo	Older,outdatedPrintShopextension
ket	Older,outdatedPrintShopextension
kex	Macro(KEDIT)
kext	MacOSXKernelExtension
key	Datafile(ForecastPro)
kgb	KGBArchivefile
kit	RavenToolkitfile
kix	KixTartScript
kma	KodakMemoryBookfile
kml	KeyholeMarkupLanguagefile
kmp	KorgTrinityKeyMaPfile
kmx	KaufmanMmailWarriorMailFolder
kmz	GoogleEarthMapLocationfile
kos	MicroTypeProDocument
kp2	KruptosEncryptedfile
kpl	KazaaPlaylist
kpp	Toolpad(SmartPad)
kps	IbmKIPSbitmapgraphics
kqb	KnowledgeQuestionBasefile
kqe	W32/Spybot.KQEWormvirus
kqp	KonicaQualityPicture
krz	Kurzweil2000Sample
ksd	NativeInstrumentsAudioPatchfile
ktk	Kutoka'sMia
kwi	NavigationDatafile
kwm	WebMoneyPrivateKeyfile
kyb	Keyboardmapping(FTPSoftwarePC/TCP)
l	Lexsourcecodefile
l01	ARCDigitizedRasterGraphics
lab	Datafile(NCSS-SOLO)
lang	SkypeLanguagefile
lat	CrosswordExpressLatticefile
latex	LaTeXtypesettingsystem
lay	Wordchartlayout(APPLAUSE)
lbg	Labelgeneratordata(dBASEIV)
lbl	Label(dBASEIV-Clipper5-dBFast)
lbm	Bitmapgraphics(DeluxePaint)
lbo	Compiledlabel(dBASEIV)
lbr	CompressedfilearchivecreatedbyLU(lue220.arc)
lbt	Labelmemo(FoxPro)
lbx	Label(FoxPro)
lcf	LinkerControlFile(NortonGuidescompiler)
lck	Lockfile(Paradox)
lcl	Data(FTPSoftwarePC/TCP)
lcn	Lection(WordPerfect)
lcs	Datafile(ACT!HistoryFiles)
lcw	Spreadsheet(Lucid3-D)
ld	LongDistancecodesfile(Telix)
ld1	Overlayfile(dBASE)
ldb	Data(MSAccess)
ldf	Librarydefinitionfile(GeoworksGlue)
ldif	LDAPDataInterchangeFormat
leg	LegacyGraphicFormat
les	Lesson(check*.cbt)
let	Letter
lev	Levelfile(NetHack3.x)
lex	Lexicon(dictionary)(many)
lfa	LifeFormfile
lft	Laserprinterfont(ChiWriter)
lg	Logoproceduredefinitions(LSRHSLogo)
lgc	ProgramUseLogfile
lgo	Logoforheaderandfooter(SuperFax)
lgx	Gerberfile
lha	CompressedfilearchivecreatedbyLHA/LHARC(lha255b.exe)
lhw	CompressedAmigafilearchivecreatedbyLHWARP
lib	Libraryfile(severalprogramminglanguages)
lic	Licensefile(Shareware)
lid	KodakGalleryAlbumfile
lif	LogicalInterchangeFormatdatafile(Hewlett-Packard)
lim	CompressedfilearchivecreatedbyLIMIT(limit12.zip)
lin	Linetypes(AutoCAD)
lis	Listing(VAX)
lit	MSReadereBookfile
lix	ExtendSimulationLibraryfile
lj	TextfileforHPLJIIprinter
lko	MSOutlookExpressLinkedObject
ll3	LaplinkIIIrelatedfile(document)(LapLinkIII)
lmp	LumpFile
lmt	NokiaPCSuiteLogfile
lnd	3DLandscapeData
lng	AdobeAcrobatLanguagePluginfile
lnk	WindowsShortcutfile
loc	MicroSimPCBoardComponentLocationsReport
lod	Loadfile
log	Logfile
lok	Encryptedandcompressedarchiveformat(FileWrangler,
lpc	Printerdriver(TEKO)
lpd	HelixNutsandBoltsFile
lpf	Lytec'sDirectElectronicMedicalClaimsClaimsDirect
lpi	LivePictures
lpk	LicensedActiveXControlforInternetExplorer.
lrf	Linkerresponsefile(MSC/C++)
lrs	LanguageResourceFile(WordPerfectforWin)
lse	NokiaAudioManager
lsf	StreamingAudio/Videofile
lsl	LotusScriptLibrary
lsp	Lispsourcecodefile(Xlisp)
lss	Spreadsheet(Legato)
lst	Keyboardmacro(1stReader)
lt2	efrontierPoserfile
ltm	Form(LotusForms)
ltr	Letter
lua	LuaSourceCodefile
lvl	GameLevelfile
lvp	LucentVoicePlayer
lwa	LightWorksArchiveMaterial/Scenefile
lwd	Textdocument(LotusWorks)
lwo	NewTekLightwaveObject
lwp	IBMWordPro/LotusWordPro96/97documentfile
lwz	MSLinguisticallyEnhancedSoundfile
lx	Lexico-fileswithsourcecode
lyr	DataCADLayerfile
lzd	Differencefileforbinaries(Ldiff1.20)
lzh	CompressedfilearchivecreatedbyLHA/LHARC(lha255b.exe)
lzs	CompressedfilearchivecreatedbyLARC(larc333.zip)
lzw	CompressedAmigafilearchivecreatedbyLHWARP
lzx	Compressedfile
m	Function(program)(Matlab)
m11	Textfile(MASS11)
m1v	MPEG-1Videofile
m2p	MPEG-2ProgramStreamFormatfile
m2ts	BDAVMPEG-2file
m2v	MPEG-2VideoOnlyfile
m3	Modula3sourcecodefile
m3d	3Danimationmacro
m3u	MusicPlaylist(Winamp)
m4	M4preprocessorfile(unix)
m4a	MPEG-4AudioLayer
m4b	MPEG-4AudioBookfile
m4p	MPEG-4EncodedAudiofile
m4r	iPhoneRingtonefile
m4v	AppleVideofile
m_u	Backupofbootsector,FATandbootdir(MazeGold)
ma3	Macro(HarvardGraphics3.0)
mac	Bitmapgraphics(MacintoshMacPaint)
mad	MSAccessModuleShortcut
maff	MozillaArchiveFormatfile
mag	WoodyLynn'sMAGgraphicsformat(MPSMagroPaintSystem)
mai	Mail(VAX)
mak	Makefile
man	Commandmanual
map	Colorpalette
mar	MozillaArchive
mas	Smartmasterset(FreelanceGraphics)
mat	Datafile(Matlab)
max	Maxsourcecodefile
mb	Memofieldvaluesfordatabase(Paradox)
mbf	MSMoneyBackupfile
mbk	Multipleindexfilebackup(dBASEIV)
mbx	Mailbox(Eudora/Zerberus)
mcc	Configurationfile(Mathcad)
mcd	Document(Mathcad)
mcf	Mathcadfont
mci	Mcicommandscript(MediaControlInterface)
mcp	Applicationscript(Capsule)
mcr	DataCADKeyboardmacrofile
mcw	Textfile(MacWriteII)
mcx	Graphicfile
md	CompressedfilearchivecreatedbyMDCD(mdcd10.arc)
md5	MD5Checksumfile
mda	Data(MSAccess)
mdb	Database(MSAccess)
mde	MicrosoftAccessMDEdatabase
mdf	AccelioCaptureClassic(JetForm)Filler
mdi	MicrosoftOffice2003imagingformat
mdk	KeyboardMapfile
mdl	Model(3DDesignPlus)
mdm	Modemdefinition(TELIX)
mdmp	MicrosoftWindowsXPTroubleReport
mdr	FaxTalkModemDoctorModemReportfile
mdt	Datatable(MSILinkincrementallinker)
mdx	Multipleindexfile(dBASEIV)
mdz	MSAccessWizardTemplate
me	UsuallyASCIItextfileREAD.ME
meb	MacroEditorbottomoverflowfile(WordPerfectLibrary)
med	MacroEditordeletesave(WordPerfectLibrary)
mem	MacroEditormacro(WordPerfectLibrary)
meq	MacroEditorprintqueuefile(WordPerfectLibrary)
mer	MacroEditorresidentarea(WordPerfectLibrary)
mes	MacroEditorworkspacefile(WordPerfectLibrary)
met	Document(OmnipagePro)
meu	Menugroup(DOSShell)
mex	Mexfile(executablecommand)(Matlab)
mf	Metafonttextfile
mfx	ImageMAKERFaxViewerfolderfile
mgf	Font(Micrografx)
mgi	ModularGatewayInterface
mgp	MagicPointPresentationfile
mhp	MSHomePublishingProject
mht	MSMHTMLDocument
mia	MusicIndiaOnlineplayermusicfile
mib	SnmpMIBfile
mic	MicrosoftImageComposerfile
mid	StandardMIDIfile(musicsynthetizers)
mif	MakerInterchangeFormat(FrameMaker)
mii	Datafile(MicroStat-II)
mim	MIMEfile
mio	MultimediaInteractiveObject
mip	PaintShopProMultipleImagePrintfile
mis	DeltaForceLandWarriorMission
mix	Objectfile(PowerC)
mk	Makefile
mkd	PervasiveBtrievefiles
mke	Makefile(MSWindowsSDK)
mki	JapanesegraphicsMAKIchanformat(MagView0.5)
mks	Data(TACT)
ml3	Project(Milestones3.x)
mlb	Macrolibraryfile(Symphony)
mlm	NovelGroupwisee-mailfile
mm	Textfile(MultiMateAdvantageII)
mmc	MediaCatalog
mmd	Peristudio/PeriProducerfile
mmf	Mailmessagefile(MSMail)
mml	MailMetaLanguage
mmm	Movie(RIFFRMMPformat)(MacroMindDirector3.x)
mmo	Memowriterfile(RapidFile)
mmp	OutputvideoformatfromBravadoboard
mmx	Command&ConquerRedAlert2Mapfile
mmz	MusicMatchThemefile
mnd	Menusource(AutoCADMenuCompiler)
mng	Map(DeLormeMap'n'Go)
mnt	Menumemo(FoxPro)
mnu	Advancedmacro(HPNewWave)
mnx	Compiledmenu(AutoCAD)
mny	Accountbook(MSMoney)
mob	Devicedefinition(PENWindows)
mod	Modula-2sourcecodefile(ClarionModula-2)
mol	MDLMolfile
mon	Monitordescription(ReadMail)
mov	QuickTimeVideoClip
mp2	Mpegaudiofile(xing)
mp3	mp3PROAudiofile
mp4	MPEG-4VideoFile
mpa	MPEGAudioStream,LayerI,IIorIII
mpc	Calenderfile(MSProject)
mpd	MSProjectdatabasefile
mpe	MPEGMovieClip
mpeg	MPEGMovieClip
mpf	MSDesignGallery
mpg	MPEG-1animation
mpl	PlaylistDatafile
mpls	Blu-rayInformationfile
mpm	Mathplanmacro(WordPerfectLibrary)
mpp	Projectfile(MSProject)
mpq	BlizzardGameDatafile
mpr	Generatedprogram(FoxPro)
mps	MultimediaFile
mpt	Bitmapgraphics(MultipageTIFF)
mpv	Viewfile(MSProject)
mpw	MosASCIIProjectWorkspacefile
mpx	Compiledmenuprogram(FoxPro)
mrb	MultipleResolutionBitmapgraphics(MSC/C++)
mrc	MIRCScriptfile
mrk	InformativeGraphicsmarkupfile
mrs	MacroResourcefile(WordPerfectforWin)
msc	MSCmakefile
msd	MSDiagnosticUtilityReport
msf	MultipleSequencefile
msg	Message
msi	WindowsInstallerfile
msm	MultiSIMCircuitDiagram
msn	MSNContentPlusfile
mso	MathScriptObjectfile
msp	Bitmapgraphics(MicrosoftPaint)
mspx	XMLbasedWebPage
mss	Manuscripttextfile(PerfectWriter-Scribble-MINCE-
mst	ChemFinderChemicalStructureIndex
msu	WindowsUpdatefile
msv	SonyMemoryStickFormat
msw	Textfile(MSWord)
mswmm	WindowsMovieMakerProject
msx	CompressedCP/MfilearchivecreatedbyMSX
mtd	DigitalSheetMusic
mth	Mathfile(Derive)
mtm	MultitrackerModulemusic
mts	AVCHDVideofile
mtv	MTVMusicGenerator
mtw	Datafile(Minitab)
mtx	TemporaryFileoftenusedbyabrowserorTWAINdevice
mu	Menu(QuattroPro)
mu3	MyriadMusicfile(packedsounds&digitaltracks)
muf	ProtoMuckMultiUserForthProgram
mul	UltimaOnlineGame
mus	MusicTimeSoundfile
mvb	Database
mvc	MusicCollectorCollectionManagerfile
mvd	MicroDVD(DVDmoviefile)
mvf	Stopframefile(AutoCADAutoFlix)
mvi	Moviecommandfile(AutoCADAutoFlix)
mvw	Logfile(SaberLAN)
mwf	Animation(ProMotion)
mwp	LotusWordpro97Smartmasterfile
mws	MapleWorksheetFile
mwv	MovieWorksfile
mxd	GISProjectfile
mxe	MacroExpress
mxf	MaterialeXchangeFormatfortheinterchangeof
mxl	MoxcelSpreadsheetFile
mxm	MSProject/OutlookTeamAssignTask
mxp	MacromediaExtensionManager
mxt	Data(MSC)
myp	Presentation(MMMakeYourPoint)
myr	MyriadMusicfile
mys	MystSavedGame
myt	MyriadTutorialfile
mzp	MaxscriptCompressedFile
na2	NetscapeMailfile
nam	MSOfficeNamefile
nap	Naplpsfile(VideoShow)(EnerGraphics)
nav	MSNApplicationExtension
nb	Textfile(NotaBene)
nbf	BackupNowBackupfile
nbu	NokiaPCSuiteBackupfile
nc	Graphics(netcdf)
ncb	MSDeveloperStudiofile
ncc	Cnc(ComputerNumericControl)controlfile(CamView3D)
ncd	NeroCoverDesignerDocumentfile
ncf	LotusNotesInternalClipboard
nch	OutlookExpressfolderfile
nd5	NDSRenamedfile
ndb	Networkdatabase(Intellicom-Compex)
nde	Videoformat-variousmanufacturesofsurveillancecamera
ndf	NeoPlanetBrowserFile
ndk	LotusNotes(containingthefilesrelatedtoworkspace)
ndx	Indexfile(dBASEII-III-IV-dBFast)
neb	NortecH.E.L.P.
ned	MSNApplicationExtension
nef	Nikon'sRAWformatfordigitalcameras(NikonElectronic
neo	Rastergraphics(AtariNeochrome)
nes	NintendoEntertainmentSystemROMImage
net	Networkconfiguration/infofile
new	Newinfo
nfo	Infofile
ng	Onlinedocumentationdatabase(NortonGuide)
ngf	EnterasysNetworksNetSightgeneratedformatfile
ngg	NokiaGroupGraphics
nh	NetHackfile
nib	AdobeAIRfile
nif	NetImmerseFileFormat
njb	PhotoIndexfile
nlm	NetwareLoadableModule
nls	CodePageNationalLanguageSupport
nlx	Form(FormWorx3.0)
nmd	SwordSearcherfile
nmi	SwordSearcherfile
nmo	VirtoolsBehavioralObjects
nms	NumegaSoftice'sLoaderfile
nnb	newnovelistStoryOutline
nob	VersaProWordExchangefile
nol	NokiaOperatorLogo
not	AcrobatSpellingfile
now	Textfile
np	Projectschedule(NokiaPlanner)(VisualPlanner3.x)
npa	ReliaSoftWeibull++6
npf	BackupNowImagefile
npi	SourceforDGEN.EXEintepreter(dBASEApplication
nra	NeroAudio-CDCompilation
nrb	NeroCD-ROMBootCompilation
nrg	NortonRegistrationEntries
nri	NeroISOCD-ROMcompilation
nrl	iManagefile
nrw	NeroWMACompilationfile
nsc	Noderfile(Polish)
nsf	LotusNotes/Dominodatabase
nsi	NullsoftInstallSystemScript
nst	Music(NoiseTracker)
nt	Startupfiles(WindowsNT)
ntf	LotusNotes/Dominotemplatefile
nth	NokiaThemefile
ntp	NeatoCDLabels
ntr	ExecutableASCIItextfile(stripheaderandrename)
nts	Tutorial(Norton)
ntx	Index(Clipper5)
ntz	InVircibleDirectoryIntegrityInformation
nu4	NortonUtilitiesRootFile(DLL)SymantecCorporation
nuf	Messagefornewusersontheir1stcall(ProcommPlus)
numbers	iWorkNumbersSpreadsheetfile
nup	ProgramComponentUpdatefiles
nvc	NeroVisionProjectfile
nvm	AOLpressHelpfile
nwc	NoteworthyComposersongfile
nws	Infotextfile(latestnews)(ASCII)
nwr	NewWorldReportAegis/MSPLawEnforcementRecords(New
nwt	NewWorldTextAegis/MSPLawEnforcementRecords(NewWorld
nxt	Sound(NeXTformat)
nzb	NewsBinIndexfile
o	Objectfile(unix-Atari-GCC)
o$$	Outfile(Sprint)
oaz	Fax(NetFaxManager)
ob	Objectcut/pastefile(IBMLinkWay)
obd	MSOfficeBinder
obj	Objectcode(IntelRecolatableObjectModule)
obr	Objectbrowserdatafile(BorlandC++)
obs	Script(ObjectScript)
obv	Visualinterface(ObjectScript)
oca	ControlTypelibCache
ocf	ObjectCraftFile(ObjectCraft)
ocm	AOLAdvertisingControlfiles
ocp	AdvancedArtStudio
ocr	Incomingfaxtranscribedtotext(FAXGrapper)
oct	RadianceOctreeFormat
ocx	OLEActiveXcustomcontrol
odf	OpenDocumentInterchange
odg	OpenDocumentGraphicfile
odl	Typelibrarysource(VisualC++)
odp	OpenOfficePresentationfile
ods	OpenOfficeSpreadsheetfile
odt	OpenOfficeOpenDocumenttextdocument
oeb	OutlookExpressBackupWizard
oem	TextSetupOEMfile
ofc	OpenFinancialConnectivityfile
ofd	Formdefinition(ObjectView)
off	ObjectFileFormatvectorgraphics
ofm	Adobefont
oft	MSOutlookItemTemplate
ofx	OlicomFax
ogg	OggVorbisCodecCompressedWAVfile
ogm	OggVorbisCompressedVideofile
ogv	VideoContainerfile
okt	Music(Oktalizer)
olb	Objectlibrary(VAX)
old	Backupfile
ole	ObjectLinkingandEmbeddingObject
oli	Textfile(Olivetti)
oma	OpenMGMusicfile
omf	OpenMediafile
omg	OpenMGJukebox
oms	BriggsSoftworksOrderMaven
ond	LotusNotes-relatedfile
one	OneNoteDocumentFile
ont	Biblefile
oom	Swapfile(Shroom)
opd	Omnipagefile
opf	FlipAlbumfile
opl	PsionOrganiserProgrammingLanguageSourcefile
opn	Activeoptions(Exact)
ops	MicrosoftOfficeprofilesettingsfile
opt	Optimizesupportfile(QEMM)
opw	Organizationchart(OrgPlusforWindows)
opx	Inactiveoptions(Exact)
or2	LotusOrganizer2file
or3	LotusOrganizer97file
or4	LotusOrganizerfile
or5	LotusOrganizerfile
ora	Parameterfile(Oracle)
org	Calendarfile(LotusOrganizer)
osd	OpenSoftwareDescriptionfile
oss	MSOfficeSavedSearch
ost	MicrosoftOutlookOfflinefile
otf	OpenTypeFormat
otl	Outlinefontdescription(Z-SoftTypeFoundry)
otx	Textfile(OlivettiOlitextPlus)
out	Outputfile
ov1	Overlayfile(partofprogramtobeloadedwhenneeded)
ov2	Overlayfile(partofprogramtobeloadedwhenneeded)
ovd	Datafile(ObjectVision)
ovl	Overlayfile(partofprogramtobeloadedwhenneeded)
ovr	Overlayfile(partofprogramtobeloadedwhenneeded)
ovw	CoolEditProOverviewfile
ows	WebStudio2Projectfile
oxt	OpenOfficeExtensionfile
p	Pascalsourcecodefile
p16	Music(16channels)(ProTrackerStudio16)
p22	Patchfile(Patch22)
p65	AdobePagemakerv6.5
p7m	PKCS#7MIMEMessage
pa	PrintArtist
pa1	Worktable(PageAhead)
pab	MicrosoftOutlookpersonaladdressbook
pac	StadImage(graphics?)
pack	Pack2000Compressedfile
pad	Keypaddefinition(Telemate)
paf	PARISaudioformat
pages	Pagesdocument
pak	CompressedfilearchivecreatedbyPAK(pak251.exe)
pal	AdobePagemakerLibraryPalette
pan	Printer-specificfile(copytocoreldrw.ink)(CorelDRAW)
par	Partsapplication(DigitalkPARTS)
pas	Pascalsourcecodefile
pat	Hatchpatterns(AutoCAD-Photostyler)
pax	PaxArchivefile
pb	Fax(FAXabilityPlus)
pb1	Document(FirstPublisherforWindows)
pba	PowerbasicBASICsourcecode(Genus)
pbd	Phonebook(FaxNOW!-Faxit)
pbf	TurtleBeachPinnacleBankfile
pbi	Powerbasicincludefile(Genus)
pbk	MicrosoftXPRemoteAccessPhonebookfile
pbl	Powerbasiclibrary(Genus)
pbm	PbmPortableBitMapgraphics
pbo	ProfilerBinaryOutput(MSSourceProfiler)
pbr	MicrosoftPublisherbackupfile
pbt	ProfilerBinaryTable(MSSourceProfiler)
pc	TextfilecontainingIBMPCspecificinfo
pc3	Custompalette(HarvardGraphics3.0)
pc8	AsciitextIBM8characterset(NewWaveWrite)
pca	CashRegisterExpressprogram
pcb	BroderbundPrintShopBusinessCard
pcc	Cutoutpicturevectorgraphics(PCPaintbrush)
pcd	Graphics(KodakPhotoCD)
pcf	ProfileConfigurationfile
pch	Patchfile
pcj	Multimediaauthoringtoolgraphics(IBM'sLinkaway-Live)
pck	ReceivedPackagefile
pcl	HP-PCLgraphicsdata(HPPrinterControlLanguage)
pcm	PlasmacamCAD/CAMsystemfile
pcs	PICSAnimation
pct	BitmapGraphic
pcw	Textfile(PCWrite)
pcx	Bitmapgraphics(PCPaintbrush)
pd	SynerGEEStonersoftwarefiles(compressiblepipeflow
pda	Bitmapgraphics
pdb	Data(TACT)
pdc	PersonalDatabaseCreatorfile
pdd	AdobePhotoDeluxeImage
pde	PrincipalmDataExtractfiles
pdf	AdobePortableDocumentFormat
pdg	PrintshopDeluxefiles
pdl	ProjectDescriptionLanguagefile(BorlandC++4.5)
pdr	Portorprinterdriver
pds	Incredimail
pdt	ProCitePrimaryDatabase
pdv	Printerdriver(Paintbrush)
pdw	Document(ProfessionalDraw)
pdx	AdobeAcrobatIndexfile
pe4	PhotoExplorerThumbnail
pea	PeaZipCompressedFileArchivedfiles
peb	ProgramEditorbottomoverflowfile(WordPerfectLibrary)
ped	ProgramEditordeletesave(WordPerfectLibrary)
pem	ProgramEditormacro(WordPerfectLibrary)
peq	ProgramEditorprintqueuefile(WordPerfectLibrary)
per	ProgramEditorresidentarea(WordPerfectLibrary)
pes	ProgramEditorworkspacefile(WordPerfectLibrary)
pet	ProgramEditortopoverflowfile(WordPerfectLibrary)
pf	WindowsPrefetchfile
pfa	Type3fontfile(unhintedPostScriptfont)
pfb	Type1PostScriptfontfile
pfc	Textfile(FirstChoice)
pfg	jEEPersfile
pfk	Programmablefunctionkeys(XTreePro)
pfl	FamilyLawyerDatafile
pfm	WindowsType1fontmetricfile
pfs	Database(PFS:FILE)-textfile(PFS:Write)
pft	Printerfont(ChiWriter)
pg	PagefoxFile
pgi	PrinterGraphicsFiledevicedriver(PGRAPHlibrary)
pgm	PortableGrayscalebitMapgraphics
pgp	Supportfile(PrettyGoodPrivacyRSASystem)
pgs	Manualpage(man4dos)
ph	Optimized.gohfile(Geoworks)
phb	NewLeafPhraseBook
phn	Phonelist(UltraFax-QmodemPro)
php	PHPScript
pho	Phonedatabase(MetzPhoneforWindows)
phr	Phrases(LocoScript)
phtml	PHPScript
pic	Pixarpicturefile(SDSCImageTool)
pif	ProgramInformationFile(Windows3.x)
pim	PIMArchivefile
pip	Personalizedmenuandtoolbar(MSOffice)
pit	CompressedMacfilearchivecreatedbyPACKIT
pix	Aliasimagefile(SDSCImageTool)
pj64	Project64gamefiles.mswmmWindowsMovieMakerProject
pj	Project(CA-SuperProject)
pjt	Projectmemo(FoxPro)
pjx	Project(FoxPro)
pk	Packedbitmapfontbitmapfile(TeXDVIdrivers)
pk3	AmericanMcGeeAliceArchive
pka	CompressedfilearchivecreatedbyPKARC
pkd	TopSecretCryptoGoldfile
pkg	Installerscript(Next)
pkk	PrivateKeyfile
pkt	PacketTracerNetworkSimulationfile
pl	Perlsourcecodefile
pl1	Roomplan(3DHomeArchitect)
pl3	Chartpalette(HarvardGraphics3.0)
plb	Library(FoxPro)
plc	Add-infile(functions-macros-applications)(Lotus
pll	Pre-linkedlibrary(Clipper5)
pln	Spreadsheet(WordPerfectforWin)
plr	DescentPilotfile
pls	DisorderTracker2Sample
plt	AutoCADHPGLVectorGraphicPlotterfile
pmv	PegasusMailFilterRulefile
pmx	PegasusMailfile
pn3	Printerdevicedriver(HarvardGraphics3.0)
pnf	PrecompiledSetupInformation(Temporaryfileseenduring
png	Bitmapgraphics(PortableNetworkGraphics)
pnm	PbmPortableaNyMap(PNM)graphics
pnt	Macintoshpainting
pod	OPENPROJProjectfile
poh	Optimized.gohfile(Geoworks)
poi	Pointofinterestfile
pop	Messagesindex(PopMail)
pos	ProCiteOutputStyles
pot	PowerPointtemplate
potx	PowerPointOpenXMLTemplatefile
pov	Raytracedscenedescriptionfile(PersistenceOfVision)
pow	Chordchart(PowerChords)
pp	FreePascalSourceCodefile
ppa	PowerPointAdd-in
ppb	ButtonbarforPrintPreview(WordPerfectforWin)
ppd	PostScriptPrinterDescription(Acrobat)
ppf	TurtleBeachPinnacleProgramfile
ppg	MSPowerPointPpresentation
ppl	PolaroidpaletteplusColorKeydevicedriver(Harvard
ppm	PortablePixelMapgraphics
ppo	Pre-processoroutput(Clipper5)
ppp	Publication(PagePlus)
pps	PowerPointSlideshow
ppsx	MSOfficePowerPointSlideShowfile
ppt	Generalfileextension(PowerPoint)
ppz	PowerPointPackagedPresentation
pqa	PalmQueryApplicationFile(databaseforwirelessaccess)
pqi	PowerQuestDriveimaging
pr2	Presentation(AldusPersuasion2.x)
pr2	Printerdriver(dBASEIV)
pr3	Postscriptprinterdriver(dBASEIV)
prc	CorelPresentationfile
prd	Printerdriver(many)
pre	Presentation(FreelanceGraphics)
prf	PixelRunFormatgraphics(Improces-Fastgraph)
prg	Program(Atari)
pri	Printerdefinitions(LocoScript)
prj	Project
prm	Parameters
prn	DataCADWindowsPrinterfile
pro	Prologsourcecodefile
prs	PrinterResourceeg.fonts(WordPerfectforWin)
prt	CADKEYPartfile
prx	WindowsMediaSettingsfile
prz	FreelanceGraphics97file
ps	PostScriptfile(text/graphics)(ASCII)
ps2	PostScriptLevel2file
psb	PinnacleSoundBank
psd	AdobePhotoshopfile
pse	Bitmapgraphics(IBMprinterPageSEgment)
psf	PhotoshopProofSettingsfile
psi	PSIONA-lawAudio
psm	Music(MASI-ProTracker)
psmdoc	PrintShopMail
psp	PaintShopProImage
psr	ProjectSchedulerResourcefile
pst	MSOutlookpersonalfolder
psw	WinXPBackupPasswordFile
pt3	Devicedriver(HarvardGraphics3.0)
pt4	Template(PageMaker4)
ptb	Script(PubTechBatchWorks)
ptm	Macro(PubTechBatchWorks)
ptn	PaperPortThumbnailImages
ptp	Act!ModemSyncfile
ptr	Qwkreaderpointerfile(QMail)
pts	InfinityEngineGameTileset
ptx	RealLegalE-Transcript
pub	Pagetemplate(MSPublisher)
put	CompressedfilearchivecreatedbyPUT(put334.zip)
puz	AcrossLiteCrosswordPuzzle
pva	HauppaugeDVB-Software
pvd	Script(Instalit)
pvm	ParallelVirtualMachinesoftwarelibrary
pvl	Library(Instalit)
pvt	LocalFidonetpointlist
pw	Textfile(ProfessionalWrite)
pwd	PocketWorddocument
pwf	ProCiteWorkforms
pwi	PocketWorddocument
pwl	PasswordList
pwm	WebMoneyPursefile
pwp	Textdocument(ProfessionalWritePlus)
pwz	MSPowerpointWizard
px	Primarydatabaseindex(Paradox)
pxl	PocketExcelSpreadsheet
pxv	ModelworksProjectFileusedinJPadProandSitePadPro
py	Pythonscriptfile
pyc	CompiledPYTHONscriptfile
pyd	BinaryPythonExtensiononWindows
pyw	PythonGUIScriptonWindows
pz2	CuriousLabsPoserPosefile
pz3	CuriousLabsPoserDocument
pza	MGIPhotoSuiteII/III/4Albumfile
pzd	Defaultsettings(PizazzPlus)
pzl	Jigs@wPuzzle
pzo	Overlayfile(PizazzPlus)
pzp	MGIPhotoSuiteII/III/4Projectfile
pzs	Settings(PizazzPlus)
pzt	Transferfile(PizazzPlus)
pzx	Swapfile(PizazzPlus)
q05	IntuitCanadaQuicktaxfile,taxreturnfile
q9q	BladeProGraphicPluginfile
qad	QuickArtdatabase
qag	QuickAccessGroup(NortonDesktop)
qap	Application(OmnisQuartz)
qbb	QuickBooksforWindowsBackupfile
qbe	Savedquery(QueryByExample)(dBASEIV-QuattroPro)
qbk	IntuitCanadaQuicktaxfile,backupcopyoftaxreturn
qbl	BusinessLawyerDocument
qbo	Compiledquery(dBASEIV)
qbr	QuickBooksReport
qbw	Spreadsheet(QuickBooksforWindows)
qcn	QualcommPhonebookfile
qcp	QualcommPureVoiceFile
qd0	Datafile-segment10(OmnisQuartz)
qd1	Datafile-segment1(OmnisQuartz)
qd2	Datafile-segment2(OmnisQuartz)
qd3	Datafile-segment3(OmnisQuartz)
qd4	Datafile-segment4(OmnisQuartz)
qd5	Datafile-segment5(OmnisQuartz)
qd6	Datafile-segment6(OmnisQuartz)
qd7	Datafile-segment7(OmnisQuartz)
qd8	Datafile-segment8(OmnisQuartz)
qd9	Datafile-segment9(OmnisQuartz)
qdat	QuicktimeInstallerCache
qdb	Quickendatafile
qdf	QuickenforWindowsdatafile
qdt	QuarkXpressDictionaryfile
qdv	Graphics(SteveBlackstockGiffer)
qe4	KingpinProjectfile
qef	Queryfile(Q+EforMSExcel)
qel	QuickenElectronicLibraryfile
qfl	QuickenFamilyLawyerfile
qfx	QuickenFinancialExchangefile
qhf	QIPPDAHistoryfile
qic	BackupsetforMicrosoftBackup
qif	QuickenInterchangeFormat
qix	NovaStarBackupfile
qlb	Quicklibrary(MSC/C++)
qlc	Data(PostScripthelpfile)atmfonts.qlc
qlf	FamilyTreeMakerGenealogyfile
qlp	Printerdriver(QuickLink)
qm4	Optionsorservicesfile(QMail4.xMailDoor)
qm	VirtualBoxLanguagefile
qml	QuickMarkupLanguagefile
qph	IntuitQuickenPriceHistoryfile
qpr	Generatedqueryprogram(FoxPro)
qpw	QuattroProProjectfile
qpx	Compiledqueryprogram(FoxPro)
qrp	QuickReportReportfiles
qrs	EquationEditorsupportfile(WordPerfectforWin)
qrt	Qrtraytracinggraphics
qru	SQLQueryfile
qry	Query(dBASEIV)
qsd	QuickenforWindowsdatafile
qsi	QuintessentialStereotaxicInjectorCommanderlogfiles
qst	QuakeSpyTabfile
qt	Quicktimemovie(animation)
qtc	InciteMediaAssistantfile
qtk	AppleQuickTakefileformatforWindows
qtl	QuickTimeMediaLinkfile
qtp	QuickTimePreferences
qts	MacintoshPICTimage
qtx	QuickTimeimage
que	CuteFTPQueuefile
qvm	Quakefile
qvs	CasioDigitalCamerafile
qw	SymantecQ&AWritefile
qwk	QWKreadermessagefile
qxd	QuarkXPressdocumentfileformat
qxl	Elementlibrary(QuarkXPress)
qxp	QuarkXPressprojectfile
qxt	Templatefile(QuarkXpress)
r	Ratfor(FORTRANpreprosessor)file
r33	TrainSimulatorGamefile
r8	Rawgraphics(onebyteperpixel)planeone(PicLab)
r8p	Pcl4bitmapfontfile(Intellifont)
ra	Music(RealAudio)
ram	Ramfile(RealAudio)
rar	CompressedfilearchivecreatedbyRAR(rar1_402.exe)
ras	SunRasterfilegraphics
rat	Datafile(RATS)
raw	RawRGB24-bitgraphics
rb	RubyonRailsclassfile
rbf	WindowsInstallerRollbackfile
rbn	Richard'sBridgeNotation
rbs	WindowsInstallerRollbackScriptfile
rbx	FormatforplayingRapidPlayerv3.0ActiveXControlin
rc	Resourcescript(VisualC/C++-BorlandC++)
rcf	RhapsodyStoragefile
rcg	Netscapenewsgroupfile(netsc.rcg)
rcp	Recomposer'sMIDISequencerMusicfile
rcx	LegoMindstormsRoboticsInventionSystem
rdb	TrueVectorRulesdatabase
rdf	CompiledUICsourcecode(GeoworksUICompiler)
rdi	Device-independentbitmapfile(RIFFRDIBformat)
rds	RayDreamStudiofile
rdx	Datafile(Reflex)
rec	Datafile(EpiInfo)
red	Pathinfo(ClarionModula-2)
ref	Cross-reference
reg	OLERegistration(Windows3.x)
rels	MicrosoftOffice2007Relationships
rem	EncryptedDatafile
rep	QWKreaderreplyfile
req	Request
res	Compiledresource(MSC/C++-BorlandC++)
rev	Revisionfile(Geoworks)
rex	Rexxsourcecodefile
rex	Reportdefinition(Oracle)
rez	Resourcefile
rf	Sunrastergraphics
rfl	RollForwardLogfile
rft	Dca/RFTRevisableFormatTextfile(IBMDisplayWrite
rgb	SgiRGBimagefile(SDSCImageTool)
rgi	RealArcadeGameInstaller
rgp	RealArcadeGamePackage
rgs	RealArcadeGameInstaller
rgx	Symboltablesetc.info(ReaGeniXcodegenerator)
rh	Resourceheaderfile(BorlandC++4.5)
rhp	RhapsodyNotationProgramFileFormat
ri	Data(Lotus1-2-3)
rib	GraphicsinRendermanformat(3DReality)
ric	Fax(Ricoh)
rif	Riffbitmapgraphics(FractalDesignPainter)
rip	Graphics(RemoteAccess)
rix	Bitmapgraphics(ColorRIXVGAPaint)
rl4	Bitmapgraphics
rl8	Bitmapgraphics
rla	Wavefrontrasterimagefile(SDSCImageTool)
rlb	Data(HarvardGraphicsWin)hgw.rlb
rlc	Graphics1bit/pixelscanneroutput
rle	UtahRunLengthEncodedrastergraphic(SDSCImageTool)
rlz	Realizersourcecodefile(CA-Realizer)
rm	RealMediafile
rmf	RichMapFormat
rmi	Midifile(RIFFRMIDformat)
rmj	RealJukeboxfile
rmk	Makefile(ClipperRMake)
rmm	RealPlayerfile
rmr	ResumeMakerfile
rms	SecureRealMediafile
rmvb	VideofileforRealplayer
rm	RealMedia
rmvb	RealMediavideofile
rmx	RealJukeBoxMP3file
rn	XplprogramforNotaBeneusers
rnd	RenderingSlide(AutoCADAutoShade)
roi	ActuateReportBlastfile
rno	Runofffile(VAX)
rol	FmmusicAdlibMusicFile(Roland)
rpd	Database(RapidFile)
rpl	Textdocument(Replica)
rpm	RedHatPackageManager
rps	PropellerheadSoftwareReasonSong
rpt	Report
rrd	ERDASImaginefile
rs	Datafile(AmigaResource-Reassembler)
rs_	ResourceforkofaMacintoshfile(Mac-ette)
rsb	RedStormImageFormat
rsc	Resourcefile
rsm	ReliaSoftMPC3
rsp	Responsefile
rss	RockwellLogixPLCfile
rst	ANSYSResults
rsw	ReliaSoftBlockSim
rtc	LiveMeetingConnectionfile
rtf	RichTextFormattextfile(many-WindowsWord)
rtl	RunTimeLibrary(NU7.0)
rtp	TurboTaxUpdatefile
rts	Runtimelibraryfile(CA-Realizer)
rtx	ReliacastAudienceManagerTurnstile
ru	JavaSoftLibraryfile
rul	InstallShield
run	RunScannerSavedfile
rv	RealVideoVideofile
rvb	Rhinoscriptfile
rvp	MSScanConfigurationfile
rvw	Review
rwg	RandomWordGeneratorListfile
rws	ResourceWorkshopdatafile(BorlandC++)
rwx	Script(RenderWare)
rwz	MSOutlookRulesWizardfile
rzk	RedZionFileCrypt(passwordfile)
rzr	in-syncSpeedRazorProjectfile
rzx	in-syncSpeedRazorProjectfile
s	Assemblysourcecodefile(Unix)
s$$	Temporarysortfile(Sprint)
s3m	Music(16channels)(ScreamTracker3.0)
sac	SharedAssetCatalog(Adobe)
saf	MusicMatchJukeboxSecureAudiofile
sah	SETI@Homedatafile
sal	Datafile(SORITEC)
sam	Textfile(Samna-LotusAmi/AmiPro)
sar	CompressedfilearchivecreatedbySAR(sar1.zip)
sas	SASSystemprogram
sas7bcat	SASSystemfilecatalog
sas7bdat	SASSystemdataset
sas7bndx	SASSystemindex
sas7bpgm	SASSystemStoredProgram
sas7bvew	SASDataSetView
sas7mdb	SASSystemmultidimensionaldatabase
sat	StandardACISTextfile
sav	Backupfile(savedfile)
sb	Audiofile(signedbyte)
sbc	SagebrushCorporationSpectrumCIRC/CATReport
sbd	Storyboard(StoryboardEditor)
sbi	SoundBlasterInstrumentfile(CreativeLabs)
sbj	MicrografxClipartorPalettefile
sbn	ArcViewfile(GIS)
sbp	Dmlprogram(Superbase4)
sbr	Supportfile(SourceBrowser)
sbs	SWATHRUOutputfile
sbt	Notesrelatedtorecord(Suberbase4Windows)
sbx	ArcViewfile(GIS)
sc	Palscript(Paradox)
sc3	RenameddBASEIIIscreenmaskfile(dBASEIV)
sca	Datafile(SCA)
scc	Textfile
scd	ScodlScanConversionObjectDescriptionLanguagegraphics
scf	Multimediashow(ScoreMaker)
sch	Projectschedule(SchedulePublisher)
sci	SystemConfigurationInformation
scm	Schemesourcecodefile
scn	Screenfile(Kermit)
sco	Highscore
scp	Script(BITCOM)
scr	Debugsourcecodefile(DOSDebug)
sct	Screenmemo(FoxPro)
scx	Bitmapgraphics(ColorRIX)
scy	Securityfile(ReaGeniX)
sda	Fidonet'sSoftwareDistributionNetworkfilearchive
sdc	StarOfficeSpreadsheet
sdd	StarOfficePresentation
sdf	SystemDataFormatfile(fixedlenghtASCIItext)
sdi	SoftwareDistributionNetworkInfofile
sdn	SoftwareDistributionNetworkcompressdfilearchive
sdr	SmartDrawfile
sds	ChartApplicationDocumentfile
sdt	SmartDrawTemplate
sdu	EdwardsSystemsTechnologyfile
sdw	StarOfficeText
sea	Self-ExtractingcompressedMacintoshfileArchive
sec	CyberPaintanimationfile(sequence)
sed	SelfExtractionDirectivefile
sep	Printerseparatorpage
seq	Atarianimationfile
ses	Sessioninfo(ClarionModula-2)
set	Configuration(1stReader)
sf	IrcamSoundFile(CSoundpackage-MixViewsoundsample
sf2	CreativeLabsSoundfontfile
sfb	HPSoftFontfile
sfc	SystemFileCheckerfile
sff	FritzFax-Printfile
sfi	Graphics(SISFramegrabber)
sfl	Pcl4bitmapfont(landscape)(Intellifont)(Ventura
sfn	Font(SPX)
sfo	CuteFTPSearchfile
sfp	Pcl4bitmapfont(portrait)(Intellifont)(Ventura
sfs	Pcl5scalablefontfile(Intellifont)
sft	Screenfont(ChiWriter)
sfv	QuickSFV/WinSFVChecksumfile
sfw	SeattleFilmWorksfile
sfx	SelfExtractingArchivefile
sg1	Graphics(StanfordGraphics)
sgf	Documentwithgraphics(Starwriter)
sgi	Graphics(IRIS-SiliconGraphics)
sgm	StandardGeneralizedMarkupLanguagefile
sgn	SierraPrintArtistSign
sgp	Statistics(STATGRAPHICSPlus)
sgt	Save/getkeyboardmacro(Signature)
sh	Unixshellscript
sh3	Presentation(HarvardGraphics3.0)
sha	ShellArchivefile
shb	Background(CorelShow)
shd	MicrosoftWindowsShadowfile
shg	Segmented-graphicsbitmap
shk	CompressedAppleIIfilearchivecreatedbySHRINKIT
shm	Shellmacro(WordPerfectLibrary)
shn	Shortenaudiocompressionfile
shp	Shapefileandsourcefilefortextfonts(AutoCAD)
shr	UnixASCIIfilearchivecreatedbySHAR(unshar.zip)
shs	MicrosoftWordorExcelscrapfilewhichiscreatedwhen
shtml	HTMLFilewithServerSide
shw	Presentation(HarvardGraphics2.0-CorelShow)
shx	Shapeentities(AutoCAD)
sid	Commodore64Musicfile
sif	SetupInstallationFilesinfo(WindowsNTSetup)
sig	Currentprogramsettings(Signature)
sik	Backupfile(Sicherungskopie)(MSWord)
sim	Aurora
sis	SymbianOSInstallerfile
sit	CompressedMacintosharchivecreatedbySTUFFIT
sitx	StuffitSITXCompressedFile
skb	SketchUpsoftwarefile(3DDesignTool)
skf	Autosketchfile
skin	Skinfile
skm	GoogleSketchupTexturefile
skn	Interfaceskinsimages(FileWrangler,SecurDesk!,
skp	Sketchupsoftwarecomponent(3DDesignTool)
sl	S-Langsourcecodefile
slb	Slidelibrary(AutoCAD)
slc	CompiledSALTscript(Telix)
sld	Slide(AutoCAD)
slf	BitDefenderfile
sli	Slide(MAGICorpSlideService)
slk	SylkSymbolicLinkformatdatafile(MultiPlan)
sll	Sounddatafile
sln	MicrosoftVisualStudioSolutionfile
slt	SaltScriptApplicationLanguageforTelixscriptsource
sm	Smalltalksourcecodefile
smc	SuperNintendoGame-consoleROMImage
smd	StarOfficeMail
smf	Fax(SMARTFAX)
smi	RealPlaySMILfile
smil	SynchronizedMultimediaIntegrationLanguagefile
smk	CompressedFile(Smacker)
smm	Macro(AmiPro)
smp	Sample(soundfile)
sms	MicrosoftPackageDefinitionfile
smt	Textfile(SmartWareII)
smtmp	SMTMPVirus
snd	Digitizedsoundfile(Macintosh/ATARI/PC)
sng	Song(midisound)(MidisoftStudio-Prism)
snm	Netscapemail
sno	Snobol4sourcecodefile
snp	CoffeeCupHTMLEditorSnippet
snx	MirageMicrodriveSnapshotExtendedVersion
so	ApacheModulefile
sol	Flashsharedobjectfile
som	Networkserialnumbers(QuattroPro)
son	Song(SBStudioII)
sou	Sounddata(soundtool)
sp	CompressedfilearchivecreatedbySPLINT(unix)
spa	MacromediaFutureSplashfile
spc	Program(MSMultiplan)
spd	Scalablefont(Speedo)(HarvardGraphics3.0)
spf	Slidepresentationfile(EnerGraphics)
spg	Glossary(Sprint)
spi	Graphics(SiemensandPhilipsscanner)
spi	InConSoftLtd.Sim-Pathsystemfiles
spl	CompressedfilearchivecreatedbySPLINT(splint.arc)
spm	Data(WordPerfect)wp{wp}.spm
spo	StatisticalProgram(SPSS)
spp	Printerfile(Sprint)
spr	Documentletter(Sprint)
sps	Spssxsourcecodefile(VAX/VMS)
spt	Spitbolsourcecodefile
spv	InConSoftLtdSim-Pathvehiclefile
spw	Worksheet(SigmaPlot)
spx	Compiledscreenprogram(FoxPro)
sql	SQLreportorquery
sqlite	SQLiteDatabasefile
sqm	ServiceQualityMonitoringfile
sqz	CompressedfilearchivecreatedbySQUEEZE(sqz1083e.exe)
src	Source(DataFlex)
srf	SunRasterFilegraphics
srp	Script(QuickLink)
srt	BSplayerSubtitlefile
ss	Bitmapgraphics(Splash)
ssa	Subtitles
ssb	SmartSyncPro
ssd	Datafile(SAS/PC)
ssf	Snagitfile
ssm	RealPlayerStandardStreamingMetafile
ssp	Datafile(SASTransport)
st	Smalltalksourcecodefile(LittleSmalltalk)
st3	MIDIKaraokefile
sta	AdobePhotoshopMatchColourImageStatisticsfile
stb	Stublibrary(GenusGXKernel)
std	StateTransitionDiagramgraphicfile(Prosa)
stf	CompressedfilearchivecreatedbySHRINKTOFIT
stg	ActiveSync(Microsoft)Backupfile
stl	C++StandardTemplateLibrary
stm	StateTransitionDiagrammodelfile(Prosa)
stn	ArcViewGeocodingStandardizationfile
sto	PascalstubOBJfile(GenusGXKernel)
stp	SharepointWebSiteTemplateFile
str	Structurelistobjectfile(dBASEApplicationGenerator)
sts	Projectstatusinfo(MSC/C++)
stt	AutomapTemplate
stu	TarantellaEnterprise33270EmulatorStylefile
stw	Datafile(SmartTermforWindows)
stx	Electronicbook(SmarText)
sty	Stylelibraryorsheet(manytextandgraphicsprograms)
sub	CloneCdrelatedfile
sui	Suitlibrary(SimpleUserInterfaceToolkit)
sum	Summary
sun	Sunrasterfilegraphics
sup	Supplementarydictionary(WordPerfectforWin)
sv4	RollerCoasterTycoonSavedGame
svd	Autosavefilefordocument(MSWord)
svg	Autosavefileforglossary(MSWord)
svgz	CompressedScaleableGraphicfile
svp	WISCOSurveyPower
svs	Autosavefileforstylesheet(MSWord)
sw	Audiofile(signedword)
swd	Storybookfile
swf	ShockWaveFlashobject
swg	Swagpacket(SWAGReader)
swi	SwishDatafile
swk	SwapkeysKeyboardFile
swp	Documentbackup(Sprint)
sxc	StarOffice/OpenOfficeSpreadsheetfile
sxw	OpenOffice.orgWriter6.0textfile
sy1	Smartpixsymbollibrary(AmiPro)
sy3	Symbolfile(HarvardGraphics3.0)
syd	BackupofstartupfilescreatedbyQEMM(?)autoexec.syd
sym	Precompiledheaders(BorlandC++)
syn	SdscSynuimagefile(SDSCImageTool)
sys	Datafile(SYGRAPH-SYSTAT-SPSS/PC)
syw	Graphicssymbols(HarvardGraphicsWin)
szc	WindowsMobile5(PocketPC)
t	Tadssource
t$m	AVGInternetSecurityTemporaryfile
t04	TaxCut2004file
t05	TaxCut2005TaxReturn
t06	TaxCut2006TaxReturn
t07	TaxCut2007TaxReturn
t08	TaxCut2008TaxReturn
t09	H&RBlockAtHome2009TaxReturn
t10	H&RBlockAtHome2010TaxReturn
t11	H&RBlockAtHome2011TaxReturn
t12	H&RBlockAtHome2012TaxReturn
t2	Textease2000file
t44	TemporaryfileforSortorIndex(dBASEIV)
t64	Program(C64Semulator)
ta0	TaxActfile
tab	GuitarTablaturefile
tag	Querytagname(DataFlex)
tah	TurboAssemblerHelpfile(BorlandC++)
tal	Textillustration(TypeAlign)
tao	IsoBusterfile
tar	CompressedfilearchivecreatedbyTAR(pax2exe.zoo)
tax	TurboTaxfile
taz	CompressedASCIIfilearchivecreatedbyTARandCOMPRESS
tb1	Fontfile(BorlandTurboC)
tb2	Fontfile(BorlandTurboC)
tbf	Fax(ImavoxTurboFax)
tbh	MahJonggforWindowsTileSet
tbk	Memobackup(dBASEIV-FoxPro)
tbl	Graphics(nativeformat)(AdobePageMakerTableEditor)
tbs	Textelements??(Textbausteine)(MSWord)
tbx	Table(ProjectScheduler4)
tc	Configuration(TurboC-BorlandC++)
tch	TurboCHelpfile(BorlandC++)
tcl	ToolCommandLanguagesourcecode(Swat)
tcp	3DTopicscape(exportedinter-Topicscapetopiclink)
tcw	Drawing(TurboCADforWindows)
td	Configurationfile(TurboDebuggerforDOS)
td0	Diskimagefile(Teledisk)
td2	Configurationfile(TurboDebuggerforWin32)
tdb	Database(TACT)
tdf	Font(TheDraw)
tdh	Helpfile(TurboDebugger)
tdk	Keystrokerecordingfile(TurboDebugger)
tds	Symboltable(TurboDebugger)
tdt	ASCIIDataFileinCSVFormat
tdw	Configurationfile(TurboDebuggerforWindows)
tee	TeeChartOfficegraphic
tef	Fax(RelisysTEFAX)
tel	Hostfile(Telnet)
tem	TurboEditorMacroLanguagescript(BorlandC++)
temp	Temporaryfile
test	TestFileExtension
tex	LaTeXSourceDocumentfile
text	ASCIITextfile
tf	Configuration(TurboProfiler)
tfa	Areafile(TurboProfiler)
tfc	Cataloguefile(Tobi'sFloppyCataloguer)
tfh	Helpfile(TurboProfiler)
tfm	TexFontMetricfile(TeX)
tfs	Statistics(TurboProfiler)
tfw	ArcViewWorldFileForTIFImage
tg1	Projectfile(OnTarget)
tga	TruevisionTargabitmapgraphics
tgz	CompressedfilearchivecreatedbyTARandGNUzip(.tar.gz)
thb	KinuPixSkin
thd	Thread
thm	ThumbnailImagefile
thn	GraphicsWorkshopforWindowsThumbnail
ths	Thesaurusdictionary(WordPerfectforWin)
tib	AcronisTrueImagefile
tif	TaggedImageFileFormatbitmapgraphics(PageMaker-
tiff	TaggedImageFileFormat
til	Fuzzylogicknowledgebase(TogaiInfraLogicFuzzy-C
tim	PlaystationGameTextureImage
tis	Tileset(MahJongg3.0)
tix	ASAforUNIXTerminfoExtensionfile
tjl	Backupfile(VAXTPUeditor)
tlb	OLETypeLibrary
tlc	CompiledToolCommandLanguagesourcecode(Swat)
tlp	Project(TimeLine)
tlt	TrellixWebDesignfile
tmb	TimbuktuProConnectionDocument
tmd	Document(TextMaker)
tmf	TaggedFontMetricfile(WordPerfectforWin)
tmo	Ztgglobaloptimizerdefaultoutputfile(ZortechC++)
tmp	Temporaryfile
tmpl	eMuleWebInterfaceTemplatefile
tmq	TestMasterfile
tms	Script(Telemate)
tmv	Template(TextMaker)
toc	TableOfContents
tol	KodakPhotoenhancer
TOPC	TopicCrunchprojectfileforsavingandresubmittingSEO
tos	Self-extractingfilearchive(AtariST)
tp	Configuration(TurboPascal)
tp3	Template(HarvardGraphics3.0)
tpb	DownloadablePCLSoftfontfilebackup(HiJaak)
tpf	DownloadablePCLSoftfontfile(HiJaak)
tph	Helpfile(TurboPascal)
tpi	MicrosoftTestfile
tpl	DocumentTemplatefile
tpp	ProtectedModeUnits(BorlandPascal7.0)
tps	ClarionforWindowsdatafile
tpu	TurboPascalUnit(BGI)(TurboPascal)
tpw	Session-statefile(TurboProfilerforWindows)
tpz	CompressedfilearchivecreatedbyTARandGNUzip(.tar.gz)
tr	Session-statesettings(TurboDebuggerforDOS)
tr2	Session-statesettings(TurboDebuggerforWin32)
trace	ECXpertDebuggingfile
trc	Debugsupportfile(PowerCTrace)
tre	Directorytreefile(PC-Tools)
trg	SymantecLiveUpdatefile
tri	Trigramfile
trk	KermitScriptfile
trm	Terminalsettings(Windows3.x)
trn	Translationsupportfile(Quattro)
trp	Tripmakerfile
trs	Executablefile(Micrografx)
trw	Session-statesettings(TurboDebuggerforWindows)
trx	RouterFirmwarefile
ts	TransportStreamfile
tsk	SkinsforPocketPCPDAs
tsp	WindowsTelephonyServiceProvider
tst	Printertestfile(WordPerfectforWin)
tsv	TabSeparatedValuefile
tt10	Turbotax2010Returnfile
tta	TheTrueAudioCodecfile
ttc	OpenTypefontfile
ttf	TruetypeFontfile
tub	PaintShopProTubefile
tut	Tutorial
tv	Tableviewsettings(Paradox)
tv1	OverflowfileaboveinsertpointinDoc1(WordPerfectfor
tv2	OverflowfileaboveinsertpointinDoc2(WordPerfectfor
tv3	OverflowfileaboveinsertpointinDoc3(WordPerfectfor
tv4	OverflowfileaboveinsertpointinDoc4(WordPerfectfor
tv5	OverflowfileaboveinsertpointinDoc5(WordPerfectfor
tv6	OverflowfileaboveinsertpointinDoc6(WordPerfectfor
tv7	OverflowfileaboveinsertpointinDoc7(WordPerfectfor
tv8	OverflowfileaboveinsertpointinDoc8(WordPerfectfor
tv9	OverflowfileaboveinsertpointinDoc9(WordPerfectfor
tvf	Tableviewsettings(dBASE)
tvo	TeveoLive
tvp	NVIDIAGraphicCardUpdatefile
tvr	NavicatforMySQLfile
tvt	RealPlayer
txd	GrandTheftAuto3Texturefile
txf	CompressedfilearchivecreatedbyTARandFREEZE(.tar.f)
txi	Supportfile(TeX)
txl	Genesis3DTexturefile
txt	Textfile
tym	TimeStamp(PageMaker4)
tz	CompressedfilearchivecreatedbyTARandCOMPRESS
tzb	CompressedfilearchivecreatedbyTAR-COMPRESS-BTOA
uax	UnrealAudiofile
ub	Audiofile(unsignedbyte)
uc2	CompressedfilearchivecreatedbyUltraCompressorII
ucn	NewcompressedfilearchivecreatedbyUltraCompressorII
ucs	UniversalClassificationStandardDatabasefile
udc	AcrobatSpellingfile
udf	Filter(Photostyler)
udl	MSDataLink
uds	SierraGenerationsFamilyfile
ue2	EncryptedfilearchivecreatedbyUltraCompressorII
ufo	UleadPhotoImpactGraphicfile
uha	UHARCCompressedArchivefile
uhs	UniversalHintSystem(binaryfile)
ui	Espiresourcecodefile(GeoworksUICompiler)
uif	MagicISODiscImagefile
uih	Espireheaderfile(GeoworksUICompiler)
uis	WindowBlinds(CopyrightNeilBanfield&Stardock.net,Inc.)
ul	Ulawaudiofile
uld	Informationaboutuploadedfiles(ProcommPlus)
ult	Music(UltraTracker)
umb	Backupfile(MemMaker)
umd	UniversalMediaDiscfile
umf	Stockmoves,MOTEKBV
umx	Unrealmusicfile
uni	Unimodmusicmodule(MIKMOD)
unl	GarminUnlockfile
unq	FaxViewfile
uns2	UltraNotesBackupfile
unx	TextfilecontainingUNIXspecificinfo
upd	Programupdateinfo
upg	FirmwareUpgradefile
upo	Compiledupdatedata(dBASE)
upx	ULeadPhotoExpressSavedImagefile
url	UniformResourceLocator(Internetshortcut)
urls	GetRightURLListfile
usb	D-LinkFMRadioUpdate
user	VisualStudioUserOptionsfile
usp	PrinterfontwithUSASCIIextendedcharacterset
usr	Userdatabasefile(ProcommPlus-TurboC++tour)
utf	AOLUpdatingFiles
utl	Soundfile
utx	UnrealEngineTexturefile
uu	CompressedASCIIfilearchivecreatedbyUUDE/ENCODE
uue	CompressedASCIIfilearchivecreatedbyUUENCODE
uvf	CSV(commaseparatedvalue)format.UsedbyNetica
uvr	UleadCool360Viewerfile
uw	Audiofile(unsignedword)
uwl	WordPerfectUserWordListfile
v	Consistencychecksupportfile(ReaGeniXcodegenerator)
v2	MicrosoftLiveMessengerdatafile
v64	Nintento64EmulationROMImage
val	Validitychecksandreferentialintegrity(Paradoxfor
van	Animation(VistaPro)
var	Variablefile(IconAuthor)
vbc	VisualBusinessCards
vbd	ActiveXfile
vbe	VBScriptEncodedScriptfile
vbn	NortonCorporateanti-virusquarantinedfile
vbp	VisualBasicProjectfile
vbs	VisualBasicScriptfile(VisualBasic)
vbw	VisualBasicProjectWorkplace(VisualBasic)
vbx	VisualBasiceXtension(VisualBasic)
vc	Includefilewithcolordefinitions(Vivid2.0)
vc4	VirtualCD/DVDImagefile
vcd	VisualCADDDrawingfile
vce	VisualCEClassTypefile
vcf	VCardfile
vch	InterlockPublicComputerUtility
vcmf	VAIOContentMetadatafile
vcs	vCalenderfile
vcw	Visualworkbenchinformation(MSVisualC++)
vcx	Spreatsheet(VisiCalcAdvanced)
vda	Bitmapgraphics
vdb	NortonAntiVirusCorporateEditionUpdatefile
vdf	AviraAntiVirvirusdefinitionfile
vdi	VirtualDiskImagesfiles
vdj	VirtualDJSamplefile
vdm	VDMPlay
vdr	Drawing(ComputerEasyDraw)
vdx	XMLforVisioDrawingfile
vem	VeeProEmbroiderySoftwareFormat
ver	VersionDescriptionfile
vew	Viewfile(Clipper5,LotusApproach)
vfm	VotingForm(Voter)
vfn	VotingFormforCustomers(Voter)
vfp	TMPGEncVFAPIPlug-in
vfs	VirtualFileSystemIndex
vfx	UleadVideoStudioSamplefile
vga	Vgadisplaydriver
vgd	Vgadisplaydriver(GenericCADD)
vgr	Graphics(VenturaPublisher)
vhd	VirtualHardDiskfile
vi	Graphics(JovianLogicVI)
vic	Vicargraphics
vid	Videofile
vif	KhorosVisualizationimagefile(SDSCImageTool)
vik	Vikinggraphics
vir	VirusInfectedfile
vis	Visgraphics
viv	VivoActivePlayerVideofile
vlm	Ashlar-Vellumfile
vlt	WinVaultContainerfile
vm	VirtualMemoryfile(Geoworks)
vm1	PanasonicSDVoiceEditorfile
vmc	Virtualmemoryconfiguration(Acrobatreader)
vmdk	VMwareImagefile
vmf	Fontcharacteristics(VenturaPublisher)
vmg	TextMessagefiles
vml	VectorMarkupLanguage
vmo	MobilePhonevoicefile(SiemensSl45)
vmp	LogosLibrarySystem2.xVerseMap
vms	TextfilecontainingVMSspecificinfo
vmt	ValveMaterialfile.Detailshowamaterialistobe
vmx	VMwareConfigurationfile
vnt	vNotefile
vo	Includefilewithobjectdefinition(Vivid2.0)
vob	DVDvideomoviefile
voc	Digitizedsamples(CreativeVoicefile)
vof	Objectfolder(VZProgrammer)
vol	VOLArchivefile
vor	OpenOffice.orgTemplate
vox	VoxAudio
vp6	TrueMotionVP6Videofile
vpa	ExciteChatGesturesfile
vpd	VirpetPerformanceDescriptor
vpg	Graphics(VPGraphics)
vpk	SteamPackageArchivefile
vpl	KaraokePlayerPlaylistfile
vpp	VirtualPoolGame
vqe	YamahaSound-VQLocatorFile
vqf	YamahaSound-VQFile
vql	YamahaSound-VQLocatorFile
vrd	VRScapedatafile
vrm	Overlayfile(QuattroPro)
vro	PanasonicDVDRecorderfile
vrp	Project(WATCOMVX?Rexx)
vrs	VideoResourceeg.videodevicedriver(WordPerfect)
vs	Includefilewithsurfacedefinition(Vivid2.0)
vsd	Diagram(ShapewareVisio)
vsl	GetRightDownloadListfile
vsm	Simulationmodel(VisSim)
vsp	VisualStudiofile
vss	Smartshapesfile(ShapewareVisio)
vst	TruevisionVistabitmapgraphics
vtf	ValveTexturefile.Usedtostoretexturedata
vts	DVDFileformat
vtx	XMLforVisiotemplatefile
vue	Animation(3DStudio)
vw	Textfile(Volkswriter)
vw3	Textfile(Volkswriter3)
vwl	VideoWaveVideoWaveLibrary
vwr	Fileviewerfile(PCTools)
vwt	VideoWaveThumbnail
vxd	Virtualdevicedriver(MSWindows)
vyd	VyperHelp
w	DatabaseAppBuilderSourceCodefile
w02	MultipleArchivefile
w30	Printerfont(ASTTurboLaser)(VenturaPublisher)
w31	Startupfile(Windows3.1)
w3g	WarcraftIIIfile
w3m	WarcraftIIIMapfile
w44	TemporaryfileforSortorIndex(dBASE)
w5v	Winampfile
wab	OutlookFile
wac	InfinityGameEngineWAVCSound
wad	DoomGamefile
waf	Mayim'sWAFCompilerfile
wal	WinampSkinfile
war	JavaWebArchive(usedbyServlets)
wav	Waveformaudiofile(RIFFWAVEformat)
wax	WindowsMediaPlayerRedirectfile
wb1	Notebook(QuattroPro)
wb2	Spreadsheet(QuattroPro)
wb3	QuattroProforWindows
wba	WindowBlindsCompressedSkin
wbc	WebshotsPictureCollection
wbf	MsWindowsBatchFile(Catch)
wbk	Document/workbook(WordPerfectforWin)
wbmp	WirelessApplicationProtocolBitmapfile
wbt	Batchfile(WinBatch)
wbx	Webiggerfile
wbz	WebShotsfile
wcd	Macrotokenlist(WordPerfectforWin)
wcm	Datatransmissionfile(MSWorks)
wcp	Productinformationdescription(WordPerfectforWin)
wd2	InfoSelectforPalmOrganizerfile
wdb	Database(MSWorks)
wdf	ReliaSoftWeibull5.0
wdl	WindowsXPWatchdogLogfile
web	Websourcecodefile
wer	MicrosoftWindowsErrorReportfile
wfc	WindowsConnectNowfile
wfm	Formobject(dBASEFormDesigner)
wfn	Font(CorelDRAW)
wfx	Datafile(Winfax)
wg1	Worksheet(Lotus1-2-3/G)
wg2	Worksheet(Lotus1-2-3forOS/2)
wgt	OperaWidgetfile
wid	Widthtable(VenturaPublisher)
wim	ImageFormatfile
win	OperaSavedWindowfile
wiz	Pagewizard(MSPublisher)
wjp	WildTangentBranded.jpgfile
wk1	Spreadsheet(Lotus1-2-3version2.x-Symphony1.1+)
wk3	Spreadsheet(Lotus1-2-3version3.x)
wk4	Spreadsheet(Lotus1-2-3version3.4)
wkb	Document(WordPerfectforWin)
wke	Spreatsheet(Lotus1-2-3educationalversion)
wkq	Spreatsheet(Quattro)
wks	Spreadsheet(Lotus1-2-3version1A-Symphony1.0-MS
wll	WordAdd-in
wlk	Graphics(VirtusWalkthrough)
wlt	eWalletfile
wma	MicrosoftActiveStreamingfile
wmc	BackupofstartupfilesbyWindowsMathCadautoexec.wmc
wmf	WindowsMetaFilevectorgraphics
wml	WirelessMarkupLanguage
wmv	MSActiveStreamingfile
wmz	WindowsMediaCompressedskinfile
wn	Text(NeXTWriteNow)
wnf	Outlinefontdescription(CorelDRAWnativeformat)
wo4	STABCALfile
wo7	STABCALfile
woa	Swapfile(Windows3.x)
woc	MicrosoftOffice2007Organizationfile
wor	MapInfoWorkspace
wot	WebExSavedMeetingMovie
wow	Music(8channels)(GraveModPlayer)
wp	Textfile(WordPerfect4.2)
wp3	MicrosoftPhotoStoryProjectfile
wp5	Document(WordPerfect5.x)
wpd	Document(WordPerfect6.0-PFS:WindowWorks)
wpf	Fax(WorldPort)
wpg	WildTangentBranded.PNGfile
wpj	MSWorksProjects
wpk	Macros(WordPerfectforWin)
wpl	WindowsMediaPlayerPlaylistfile/td>
wpm	Macros(WordPerfect)
wps	Textdocument(MSWorks)
wpt	WordPerfecttemplate
wpw	PerfectWorksdocument
wq!	Compressedspreadsheet(QuattroPro)
wq1	Spreadsheet(QuattroPro)
wr1	Spreadsheet(Symphony1.1-1.2-2)
wrd	Template(Charisma)
wrf	usedforWebExrecording.Microsoftofficeadd-infor
wri	Textfile(WindowsWrite)
wrk	Spreadsheet(Symphony1.0,1.2,2.0,3.0)
wrl	PlaintextVRMLfile
wrml	PlaintextVRMLfile
wrp	CompressedAmigafilearchivecreatedbyWARP
wrs	WindowsResourceeg.printerdriver(WordPerfectforWin)
ws	Textfile(WordStar5.0-6.0)
wsf	WindowsScriptfile
wss	WebScreenSaverfile(WebScreenSaver2008)
ws2	Textfile(WordStar2000)
wsc	Windowsscriptingcomponentfile
wsd	Document(WordStar)
wsf	WindowsScriptfile
wsh	WindowsScriptHostSettingsfile
wsp	Workspace(FortranPowerStation)
wsr	FirstStopWebSearchfile
wss	WebScreenSaverfile(WebScreenSaver2008)
wst	Textfile(WordStar)
wsx	WinMXFilesharingProgram
wsz	SkinZipfile(WinAmp)
wtd	WinTuneDocumentfile
wtr	MSEncartafile
wv	WavPackcompressedAudiofile
wve	ComponentofaDIVXMovieConversion
wvx	Metafile
wvw	BackupWonderwareInTouchwindowfile
wwb	Buttonbarfordocumentwindow(WordPerfectforWin)
wwk	Keyboardlayout(WordPerfectforWin)
wwp	WormsWorldPartyTeamsfile
wws	AutoRouteUserInformation
wwv	WildTangentBranded.WAVfile
wxp	Document(EXPforWindows)
wxs	EasyCrosscrosstitchfile
wzg	WZebrafile
wzs	MicrosoftWordwizard
x	DirectXObjectfile
x01	Secondaryindex(Paradox)
x02	Secondaryindex(Paradox)
x03	Secondaryindex(Paradox)
x04	Secondaryindex(Paradox)
x05	Secondaryindex(Paradox)
x06	Secondaryindex(Paradox)
x07	Secondaryindex(Paradox)
x08	Secondaryindex(Paradox)
x09	Secondaryindex(Paradox)
x16	MacromediaProgramExtension(16-bit)
x32	MacromediaProgramExtension(32-bit)
xap	SilverightApplicationPackage
xbel	XMLBookmarkExchangeLanguagefile
xbm	X11Bitmapgraphics
xcf	GimpImagefile
xdf	MilntaAPLTransferFunction
xdw	XWindowsScreenDumpfile
xef	X-GenicseManager-XMLformanddataforeManager
xem	X-GenicseManager-Meteredunits/creditdefinitionfor
xep	X-GenicseManager-Filepackaging/unpackinginformation
xes	X-GenicseManager-XMLdefinitionforUIskins
xet	X-GenicseManager-XMLdefinitionforeManagerprocess
xev	X-GenicseManager-Filedownloaddefinitionfor
xez	X-GenicseManager-TemplatepackageforeManager
xfd	XMLForminXFDLFormat
xfdl	ExtensibleFormsDescriptionLanguagefile
xfn	Printerfont(Xerox4045)(VenturaPublisher)
xft	24pinprinterfont(ChiWriter)
xfx	FaxFile(various)
xhtml	ExtensibleHyperTextMarkupLanguagefile
xi	FastTracker2InstrumentorScreamTrackerInstrumentfile
xif	Wangimagefile
xla	XlibArchive(xlibpas2.zip)
xla	Add-inmacrosheet(MSExcel)
xlb	Data(MSExcel)
xlc	Chartdocument(MSExcel)
xlk	ExcelBackup
xll	ExcelDynamicLinkLibrary(MSExcel)
xlm	Macrosheet(MSExcel)
xlr	MSWorksfile
xls	Spreadsheet(MSWorks)
xlsm	MicrosoftExcelMacro-EnabledWorkbookfile
xlsx	MicrosoftExcelXMLfile
xlt	Template(MSExcel)
xlw	Workbook(MSExcel)
xlx	XoloXIncompleteDownloadfile
xm	Music(FastTracker)
xmi	CompressedeXtendedMIdimusic
xml	ExtensibleMarkupLanguagefile
xmp	ExtensibleMetadataPlatform
xnf	StandardNetworkFileform
xpi	XPInstallFile
xnk	MicrosoftExchangeShortcut
xpl	Musicfile
xpm	X11PixelMapgraphics
xpr	MemorexCD-ROMlabelfile
xps	XMLPaperSpecificationfile
xpt	MozillaFirefoxComponentfile
xpw	LeadingMarketTechnologiesEXPO
xqt	Executablefile(Waffle)
xpv	digitalsurveillancesystem
xrf	Cross-referencefile
xsd	XMLSchemafile
xsf	MilntaAPLTransferFunction
xsl	ExtensibleStylesheetLanguagefile
xspf	XMLShareablePlaylistfile
xss	AbilityOfficeSpreadsheet
xtb	Externaltranslationtable(LocoScript)
xtm	XtremsplitDatafile
xtr	MapToolfile(anadd-onforUI-View)
xul	XMLUserInterfaceLanguagefile
xvb	WinExplorerVBScript
xvid	XvidVideofile
xvl	Compact3Dfileformatforwebapps.(Lattice3D)
xwd	XWindowSystemwindowdumpimagegraphics(SDSCImage
xwk	Keyboardmapping(Crosstalk)
xwp	Session(Crosstalk)
xx	CompressedfileASCIIarchivecreatedbyXXENCODE
xxe	CompressedfileASCIIarchivecreatedbyXXENCODE
xxx	SingerSewingMachineProfessionalSewWarefile
xy	Textfile(XYWrite)
xy3	Textfile(XYWriteIII)
xyw	Textfile(XyWriteIII)
xyz	ASCIIRPGMakerGraphicFormat
xz	XZCompressedArchivefile
y	Yaccgrammarfile
y01	Secondaryindex(Paradox)
y02	Secondaryindex(Paradox)
y03	Secondaryindex(Paradox)
y04	Secondaryindex(Paradox)
y05	Secondaryindex(Paradox)
y06	Secondaryindex(Paradox)
y07	Secondaryindex(Paradox)
y08	Secondaryindex(Paradox)
y09	Secondaryindex(Paradox)
yab	YabasicSourceCodefile
yal	Data(Arts&Letters)
ybk	MicrosoftEncartaYearbookfile
ychat	Yahoo!Messengerchatlog
yenc	yEncfile
ymg	Yahoo!Messengerfile
yml	YAMLfile
ync	yEncEncodedfile
yps	Yahoo!MessengerDatafile
yuv	YUVEncodedImageorVideofile
yz	CompressedfilearchivecreatedbyYAC
yz1	YamazakiZIPPERfile
z	CompressedfileASCIIarchivecreatedbyCOMPRESS
z01	WinzipSplitArchivefile
z02	SplitArchivefile
z1	ZoneAlarmRenamedVBfile
z3	Infocomgamemodule
zap	ZeroAdministrationPackagefile
zbd	CanonZoomBrowserDatabasefile
zdb	ZimbraDatabaseFile
zdb	
zdct	AfterEffectsLanguagefile
zdg	CompressedZiffNettextdocument(Zview)
zdl	DesignProLabelfile
zdp	ZDNetPasswordPro32
zer	Datafile(Zerberus)
zfx	ZFX-CC3FilePackerTool
zgm	Graphics(Zenographics)
zhtml	SecureIEZippedHTMLfile
zi	RenamedZipfile
zif	ZoomingImageFormatfile
zip	ZIPCompressedfilearchive
zipx	WinZipCompressedfile
zix	QuickenDatafile
zl?	ZoneAlarmMailsafeRenamedFile.
zl	ZlibCompressedfile
zls	AtlantisOceanMindWordProcessingfile
zmc	ZoneAlarmMailsafe
zom	CompressedAmigafilearchivecreatedbyZOOM
zon	GrandTheftAuto3Zonefile
zoo	CompressedfilearchivecreatedbyZOO(zoo210.exe)
zpk	ZFirmPackagefile
zpl	CreativeZenMicroplaylist
zst	ZSNESSlot0Savestate
ztd	ZiffDavisMediatextdatabase
zvd	ZyxelVoicefile(Z-Fax)
zvz	PossibleVirusfile
zxp	ExtensionManagerPackage
zz	ZzipCompressedArchivefile
zzt	ZZTGameCreationSystem
